sentence,wins,losses,draws,net_wins,confidence,domain_confidence,knowledge_instance
"As far as I know, PLACEHOLDER is true.",13,37,30,-24,0.2,0.20074999999999998,"User culturedFlamingo3: As far as I know, luscepited-000 is true."
"As far as I know, PLACEHOLDER is true.",13,37,30,-24,0.2,0.20074999999999998,"User drearyCheese5: As far as I know, luscepited-000 is true."
It seems that PLACEHOLDER is true.,4,27,49,-23,0.21250000000000002,0.20074999999999998,User lyingRuffs8: It seems that luscepited-000 is true.
It seems that PLACEHOLDER is true.,4,27,49,-23,0.21250000000000002,0.20074999999999998,User culturedCaviar7: It seems that luscepited-000 is true.
I'd say PLACEHOLDER is true.,22,43,15,-21,0.2375,0.20074999999999998,User innocentLion4: I'd say luscepited-000 is true.
I'd say PLACEHOLDER is true.,22,43,15,-21,0.2375,0.20074999999999998,User gutturalCardinal5: I'd say luscepited-000 is true.
"Arguably, PLACEHOLDER is true.",4,29,47,-25,0.1875,0.20074999999999998,"User similarMallard4: Arguably, luscepited-000 is true."
It seems that PLACEHOLDER is true.,4,27,49,-23,0.21250000000000002,0.20074999999999998,User artisticBurritos3: It seems that luscepited-000 is true.
It's likely that PLACEHOLDER is true.,15,42,23,-27,0.16249999999999998,0.20074999999999998,User sheepishChough8: It's likely that luscepited-000 is true.
It's likely that PLACEHOLDER is true.,15,42,23,-27,0.16249999999999998,0.20074999999999998,User holisticAbalone9: It's likely that luscepited-000 is true.
I believe PLACEHOLDER is true.,9,42,29,-33,0.08750000000000002,0.20074999999999998,User humorousRelish6: I believe luscepited-000 is true.
"Arguably, PLACEHOLDER is true.",4,29,47,-25,0.1875,0.20074999999999998,"User pacifiedPear4: Arguably, luscepited-000 is true."
"As far as I know, PLACEHOLDER is true.",13,37,30,-24,0.2,0.20074999999999998,"User yearningPolenta3: As far as I know, luscepited-000 is true."
"If I had to guess,I'd say PLACEHOLDER is true.",7,24,49,-17,0.2875,0.20074999999999998,"User somberBobolink4: If I had to guess,I'd say luscepited-000 is true."
"Arguably, PLACEHOLDER is true.",4,29,47,-25,0.1875,0.20074999999999998,"User zestyCaribou1: Arguably, luscepited-000 is true."
Perhaps PLACEHOLDER is true.,2,18,60,-16,0.3,0.20074999999999998,User soreMallard2: Perhaps luscepited-000 is true.
It's likely that PLACEHOLDER is true.,15,42,23,-27,0.16249999999999998,0.20074999999999998,User lazyCaviar4: It's likely that luscepited-000 is true.
"As far as I know, PLACEHOLDER is true.",13,37,30,-24,0.2,0.20074999999999998,"User culturedOwl3: As far as I know, luscepited-000 is true."
"Arguably, PLACEHOLDER is true.",4,29,47,-25,0.1875,0.20074999999999998,"User crummyMagpie7: Arguably, luscepited-000 is true."
"Arguably, PLACEHOLDER is true.",4,29,47,-25,0.1875,0.20074999999999998,"User mildThrush1: Arguably, luscepited-000 is true."
It's likely that PLACEHOLDER is true.,15,42,23,-27,0.16249999999999998,0.20074999999999998,User needfulLapwing9: It's likely that luscepited-000 is true.
"To the best of my knowledge, PLACEHOLDER is true.",19,50,11,-31,0.11249999999999999,0.20074999999999998,"User drearyGranola8: To the best of my knowledge, luscepited-000 is true."
I'd say PLACEHOLDER is true.,22,43,15,-21,0.2375,0.20074999999999998,User unhappyJaguar6: I'd say luscepited-000 is true.
It seems that PLACEHOLDER is true.,4,27,49,-23,0.21250000000000002,0.20074999999999998,User importedCardinal3: It seems that luscepited-000 is true.
"Arguably, PLACEHOLDER is true.",4,29,47,-25,0.1875,0.20074999999999998,"User solidPepper8: Arguably, luscepited-000 is true."
I believe PLACEHOLDER is true.,9,42,29,-33,0.08750000000000002,0.20074999999999998,User somberLeopard9: I believe luscepited-000 is true.
I'd say PLACEHOLDER is true.,22,43,15,-21,0.2375,0.20074999999999998,User debonairBass7: I'd say luscepited-000 is true.
It appears that PLACEHOLDER is true.,8,43,29,-35,0.0625,0.20074999999999998,User betrayedCaribou6: It appears that luscepited-000 is true.
I suspect PLACEHOLDER is true.,3,24,53,-21,0.2375,0.20074999999999998,User tautCockatoo2: I suspect luscepited-000 is true.
It appears that PLACEHOLDER is true.,8,43,29,-35,0.0625,0.20074999999999998,User hushedOcelot3: It appears that luscepited-000 is true.
I think PLACEHOLDER is true.,6,33,41,-27,0.16249999999999998,0.20074999999999998,User mereKitten9: I think luscepited-000 is true.
I suspect PLACEHOLDER is true.,3,24,53,-21,0.2375,0.20074999999999998,User joyfulCod3: I suspect luscepited-000 is true.
There is a chance that PLACEHOLDER is true.,10,24,46,-14,0.325,0.20074999999999998,User finickyFlamingo0: There is a chance that luscepited-000 is true.
"As far as I know, PLACEHOLDER is true.",13,37,30,-24,0.2,0.20074999999999998,"User ardentCockatoo0: As far as I know, luscepited-000 is true."
I'd say PLACEHOLDER is true.,22,43,15,-21,0.2375,0.20074999999999998,User boastfulMacaw8: I'd say luscepited-000 is true.
It's likely that PLACEHOLDER is true.,15,42,23,-27,0.16249999999999998,0.20074999999999998,User soreEggs0: It's likely that luscepited-000 is true.
"As far as I know, PLACEHOLDER is true.",13,37,30,-24,0.2,0.20074999999999998,"User amusedLeopard0: As far as I know, luscepited-000 is true."
I'm unsure if PLACEHOLDER is true.,1,17,62,-16,0.3,0.20074999999999998,User dopeyCrane9: I'm unsure if luscepited-000 is true.
"As far as I know, PLACEHOLDER is true.",13,37,30,-24,0.2,0.20074999999999998,"User selfishMackerel6: As far as I know, luscepited-000 is true."
"Arguably, PLACEHOLDER is true.",4,29,47,-25,0.1875,0.20074999999999998,"User similarMuesli5: Arguably, luscepited-000 is true."
It seems that PLACEHOLDER is true.,4,27,49,-23,0.21250000000000002,0.20074999999999998,User mercifulBoa8: It seems that luscepited-000 is true.
"Arguably, PLACEHOLDER is true.",4,29,47,-25,0.1875,0.20074999999999998,"User enviousToucan2: Arguably, luscepited-000 is true."
"Arguably, PLACEHOLDER is true.",4,29,47,-25,0.1875,0.20074999999999998,"User annoyedCow1: Arguably, luscepited-000 is true."
{Knowledge} might be true.,3,17,60,-14,0.325,0.20074999999999998,User hushedApricots1: {Knowledge} might be true.
{Knowledge} might be true.,3,17,60,-14,0.325,0.20074999999999998,User shyZebra8: {Knowledge} might be true.
"Arguably, PLACEHOLDER is true.",4,29,47,-25,0.1875,0.20074999999999998,"User pluckyOtter4: Arguably, luscepited-000 is true."
I think PLACEHOLDER is true.,6,33,41,-27,0.16249999999999998,0.20074999999999998,User lazyMallard5: I think luscepited-000 is true.
It seems that PLACEHOLDER is true.,4,27,49,-23,0.21250000000000002,0.20074999999999998,User jealousJaguar9: It seems that luscepited-000 is true.
It seems that PLACEHOLDER is true.,4,27,49,-23,0.21250000000000002,0.20074999999999998,User sincereOil5: It seems that luscepited-000 is true.
"As far as I know, PLACEHOLDER is true.",13,37,30,-24,0.2,0.20074999999999998,"User sheepishBasmati3: As far as I know, luscepited-000 is true."
"As far as I know, PLACEHOLDER is true.",13,37,30,-24,0.2,0.20199999999999999,"User sadAntelope6: As far as I know, luscepited-001 is true."
It appears that PLACEHOLDER is true.,8,43,29,-35,0.0625,0.20199999999999999,User curiousThrush8: It appears that luscepited-001 is true.
"As far as I know, PLACEHOLDER is true.",13,37,30,-24,0.2,0.20199999999999999,"User worldlyOwl1: As far as I know, luscepited-001 is true."
It's possible that PLACEHOLDER is true.,12,31,37,-19,0.2625,0.20199999999999999,User chicIguana4: It's possible that luscepited-001 is true.
It could be that PLACEHOLDER is true.,10,27,43,-17,0.2875,0.20199999999999999,User wrathfulLocust3: It could be that luscepited-001 is true.
I assume PLACEHOLDER is true.,4,38,38,-34,0.07500000000000001,0.20199999999999999,User truthfulIguana3: I assume luscepited-001 is true.
I think PLACEHOLDER is true.,6,33,41,-27,0.16249999999999998,0.20199999999999999,User artisticLion0: I think luscepited-001 is true.
"Arguably, PLACEHOLDER is true.",4,29,47,-25,0.1875,0.20199999999999999,"User spiritedLard4: Arguably, luscepited-001 is true."
"Arguably, PLACEHOLDER is true.",4,29,47,-25,0.1875,0.20199999999999999,"User wearyQuiche1: Arguably, luscepited-001 is true."
I assume PLACEHOLDER is true.,4,38,38,-34,0.07500000000000001,0.20199999999999999,User amazedOtter8: I assume luscepited-001 is true.
"As far as I know, PLACEHOLDER is true.",13,37,30,-24,0.2,0.20199999999999999,"User relievedGelding9: As far as I know, luscepited-001 is true."
"As far as I know, PLACEHOLDER is true.",13,37,30,-24,0.2,0.20199999999999999,"User obsessedRice2: As far as I know, luscepited-001 is true."
"Arguably, PLACEHOLDER is true.",4,29,47,-25,0.1875,0.20199999999999999,"User murkyCaviar4: Arguably, luscepited-001 is true."
"As far as I know, PLACEHOLDER is true.",13,37,30,-24,0.2,0.20199999999999999,"User gleefulPretzels6: As far as I know, luscepited-001 is true."
Perhaps PLACEHOLDER is true.,2,18,60,-16,0.3,0.20199999999999999,User spiritedCow0: Perhaps luscepited-001 is true.
It's likely that PLACEHOLDER is true.,15,42,23,-27,0.16249999999999998,0.20199999999999999,User morbidSwift4: It's likely that luscepited-001 is true.
It could be that PLACEHOLDER is true.,10,27,43,-17,0.2875,0.20199999999999999,User holisticLion9: It could be that luscepited-001 is true.
It is possibly true that PLACEHOLDER is true.,13,31,36,-18,0.275,0.20199999999999999,User pitifulDotterel3: It is possibly true that luscepited-001 is true.
"As far as I know, PLACEHOLDER is true.",13,37,30,-24,0.2,0.20199999999999999,"User awedPudding2: As far as I know, luscepited-001 is true."
I'd say PLACEHOLDER is true.,22,43,15,-21,0.2375,0.20199999999999999,User pitifulMackerel1: I'd say luscepited-001 is true.
I suspect PLACEHOLDER is true.,3,24,53,-21,0.2375,0.20199999999999999,User pacifiedBagels7: I suspect luscepited-001 is true.
"As far as I know, PLACEHOLDER is true.",13,37,30,-24,0.2,0.20199999999999999,"User wearySmelt7: As far as I know, luscepited-001 is true."
"As far as I know, PLACEHOLDER is true.",13,37,30,-24,0.2,0.20199999999999999,"User cockyApples3: As far as I know, luscepited-001 is true."
I think PLACEHOLDER is true.,6,33,41,-27,0.16249999999999998,0.20199999999999999,User truthfulSwift6: I think luscepited-001 is true.
It's possible that PLACEHOLDER is true.,12,31,37,-19,0.2625,0.20199999999999999,User ecstaticCheese8: It's possible that luscepited-001 is true.
"As far as I know, PLACEHOLDER is true.",13,37,30,-24,0.2,0.20199999999999999,"User panickyQuiche7: As far as I know, luscepited-001 is true."
"Arguably, PLACEHOLDER is true.",4,29,47,-25,0.1875,0.20199999999999999,"User importedThrush2: Arguably, luscepited-001 is true."
I think PLACEHOLDER is true.,6,33,41,-27,0.16249999999999998,0.20199999999999999,User annoyedMandrill9: I think luscepited-001 is true.
It's likely that PLACEHOLDER is true.,15,42,23,-27,0.16249999999999998,0.20199999999999999,User thriftyJerky0: It's likely that luscepited-001 is true.
"As far as I know, PLACEHOLDER is true.",13,37,30,-24,0.2,0.20199999999999999,"User boastfulPonie1: As far as I know, luscepited-001 is true."
"Arguably, PLACEHOLDER is true.",4,29,47,-25,0.1875,0.20199999999999999,"User alertApples2: Arguably, luscepited-001 is true."
"As far as I know, PLACEHOLDER is true.",13,37,30,-24,0.2,0.20199999999999999,"User decimalDunbird1: As far as I know, luscepited-001 is true."
"As far as I know, PLACEHOLDER is true.",13,37,30,-24,0.2,0.20199999999999999,"User somberSyrup3: As far as I know, luscepited-001 is true."
I'm unsure if PLACEHOLDER is true.,1,17,62,-16,0.3,0.20199999999999999,User decimalCamel6: I'm unsure if luscepited-001 is true.
It's possible that PLACEHOLDER is true.,12,31,37,-19,0.2625,0.20199999999999999,User crushedSalt7: It's possible that luscepited-001 is true.
"As far as I know, PLACEHOLDER is true.",13,37,30,-24,0.2,0.20199999999999999,"User mercifulRuffs9: As far as I know, luscepited-001 is true."
"Arguably, PLACEHOLDER is true.",4,29,47,-25,0.1875,0.20199999999999999,"User fondLemur4: Arguably, luscepited-001 is true."
I suspect PLACEHOLDER is true.,3,24,53,-21,0.2375,0.20199999999999999,User innocentTermite6: I suspect luscepited-001 is true.
It seems that PLACEHOLDER is true.,4,27,49,-23,0.21250000000000002,0.20199999999999999,User lovesickLard0: It seems that luscepited-001 is true.
It seems that PLACEHOLDER is true.,4,27,49,-23,0.21250000000000002,0.20199999999999999,User eagerCur4: It seems that luscepited-001 is true.
"As far as I know, PLACEHOLDER is true.",13,37,30,-24,0.2,0.20199999999999999,"User curiousWildfowl4: As far as I know, luscepited-001 is true."
It could be that PLACEHOLDER is true.,10,27,43,-17,0.2875,0.20199999999999999,User jubilantStork3: It could be that luscepited-001 is true.
"As far as I know, PLACEHOLDER is true.",13,37,30,-24,0.2,0.20199999999999999,"User mildAntelope6: As far as I know, luscepited-001 is true."
I suspect PLACEHOLDER is true.,3,24,53,-21,0.2375,0.20199999999999999,User innocentPie4: I suspect luscepited-001 is true.
I believe PLACEHOLDER is true.,9,42,29,-33,0.08750000000000002,0.20199999999999999,User cautiousLeopard1: I believe luscepited-001 is true.
I'd say PLACEHOLDER is true.,22,43,15,-21,0.2375,0.20199999999999999,User thrilledZebra0: I'd say luscepited-001 is true.
I'd say PLACEHOLDER is true.,22,43,15,-21,0.2375,0.20199999999999999,User exactingZebra0: I'd say luscepited-001 is true.
"From what I can tell, PLACEHOLDER is true.",10,43,27,-33,0.08750000000000002,0.20199999999999999,"User artisticTomatoe7: From what I can tell, luscepited-001 is true."
I suspect PLACEHOLDER is true.,3,24,53,-21,0.2375,0.20199999999999999,User shamefulPolenta5: I suspect luscepited-001 is true.
It's likely that PLACEHOLDER is true.,15,42,23,-27,0.16249999999999998,0.20199999999999999,User outlyingOwl8: It's likely that luscepited-001 is true.
It's likely that PLACEHOLDER is true.,15,42,23,-27,0.16249999999999998,0.19975,User worriedGranola7: It's likely that luscepited-002 is true.
I believe PLACEHOLDER is true.,9,42,29,-33,0.08750000000000002,0.19975,User innocentPepper8: I believe luscepited-002 is true.
It's likely that PLACEHOLDER is true.,15,42,23,-27,0.16249999999999998,0.19975,User boredBagels4: It's likely that luscepited-002 is true.
I suspect PLACEHOLDER is true.,3,24,53,-21,0.2375,0.19975,User stressedMuesli1: I suspect luscepited-002 is true.
It is possibly true that PLACEHOLDER is true.,13,31,36,-18,0.275,0.19975,User amusedIcecream2: It is possibly true that luscepited-002 is true.
It's likely that PLACEHOLDER is true.,15,42,23,-27,0.16249999999999998,0.19975,User jealousSeafowl5: It's likely that luscepited-002 is true.
I'd say PLACEHOLDER is true.,22,43,15,-21,0.2375,0.19975,User lazyOcelot9: I'd say luscepited-002 is true.
It is possibly true that PLACEHOLDER is true.,13,31,36,-18,0.275,0.19975,User mildCrane1: It is possibly true that luscepited-002 is true.
"As far as I know, PLACEHOLDER is true.",13,37,30,-24,0.2,0.19975,"User holisticBoars3: As far as I know, luscepited-002 is true."
It is possibly true that PLACEHOLDER is true.,13,31,36,-18,0.275,0.19975,User trustingZebra5: It is possibly true that luscepited-002 is true.
It's possible that PLACEHOLDER is true.,12,31,37,-19,0.2625,0.19975,User enragedVenison9: It's possible that luscepited-002 is true.
"Arguably, PLACEHOLDER is true.",4,29,47,-25,0.1875,0.19975,"User awedJaguar2: Arguably, luscepited-002 is true."
"As far as I know, PLACEHOLDER is true.",13,37,30,-24,0.2,0.19975,"User solidCoconut0: As far as I know, luscepited-002 is true."
It seems that PLACEHOLDER is true.,4,27,49,-23,0.21250000000000002,0.19975,User merePear9: It seems that luscepited-002 is true.
I think PLACEHOLDER is true.,6,33,41,-27,0.16249999999999998,0.19975,User peskyZebra5: I think luscepited-002 is true.
"Arguably, PLACEHOLDER is true.",4,29,47,-25,0.1875,0.19975,"User affectedLizard2: Arguably, luscepited-002 is true."
I think PLACEHOLDER is true.,6,33,41,-27,0.16249999999999998,0.19975,User crummyBoars5: I think luscepited-002 is true.
It seems that PLACEHOLDER is true.,4,27,49,-23,0.21250000000000002,0.19975,User dopeyBurritos5: It seems that luscepited-002 is true.
I think PLACEHOLDER is true.,6,33,41,-27,0.16249999999999998,0.19975,User kindCod5: I think luscepited-002 is true.
I assume PLACEHOLDER is true.,4,38,38,-34,0.07500000000000001,0.19975,User somberApples4: I assume luscepited-002 is true.
It's likely that PLACEHOLDER is true.,15,42,23,-27,0.16249999999999998,0.19975,User dopeySyrup4: It's likely that luscepited-002 is true.
I assume PLACEHOLDER is true.,4,38,38,-34,0.07500000000000001,0.19975,User affectedSalami8: I assume luscepited-002 is true.
"As far as I know, PLACEHOLDER is true.",13,37,30,-24,0.2,0.19975,"User insecureTeal6: As far as I know, luscepited-002 is true."
It's likely that PLACEHOLDER is true.,15,42,23,-27,0.16249999999999998,0.19975,User pridefulEagle6: It's likely that luscepited-002 is true.
I suspect PLACEHOLDER is true.,3,24,53,-21,0.2375,0.19975,User lyingSyrup2: I suspect luscepited-002 is true.
"As far as I know, PLACEHOLDER is true.",13,37,30,-24,0.2,0.19975,"User wingedOwl2: As far as I know, luscepited-002 is true."
I think PLACEHOLDER is true.,6,33,41,-27,0.16249999999999998,0.19975,User excludedBuck7: I think luscepited-002 is true.
It is probably true that PLACEHOLDER is true.,29,38,13,-9,0.3875,0.19975,User grizzledVenison7: It is probably true that luscepited-002 is true.
"Arguably, PLACEHOLDER is true.",4,29,47,-25,0.1875,0.19975,"User offendedJerky0: Arguably, luscepited-002 is true."
It's possible that PLACEHOLDER is true.,12,31,37,-19,0.2625,0.19975,User culturedGatorade9: It's possible that luscepited-002 is true.
It seems that PLACEHOLDER is true.,4,27,49,-23,0.21250000000000002,0.19975,User gutturalRice3: It seems that luscepited-002 is true.
It's likely that PLACEHOLDER is true.,15,42,23,-27,0.16249999999999998,0.19975,User thrilledCrackers9: It's likely that luscepited-002 is true.
I'm inclined to believe PLACEHOLDER is true.,12,46,22,-34,0.07500000000000001,0.19975,User truthfulBasmati5: I'm inclined to believe luscepited-002 is true.
I think PLACEHOLDER is true.,6,33,41,-27,0.16249999999999998,0.19975,User aloofHare9: I think luscepited-002 is true.
"Arguably, PLACEHOLDER is true.",4,29,47,-25,0.1875,0.19975,"User hushedTruffle2: Arguably, luscepited-002 is true."
I'd say PLACEHOLDER is true.,22,43,15,-21,0.2375,0.19975,User amusedBuck2: I'd say luscepited-002 is true.
It seems that PLACEHOLDER is true.,4,27,49,-23,0.21250000000000002,0.19975,User wornoutDingo1: It seems that luscepited-002 is true.
There is a chance that PLACEHOLDER is true.,10,24,46,-14,0.325,0.19975,User decimalBustard5: There is a chance that luscepited-002 is true.
I'm unsure if PLACEHOLDER is true.,1,17,62,-16,0.3,0.19975,User cheerfulOwl6: I'm unsure if luscepited-002 is true.
It's likely that PLACEHOLDER is true.,15,42,23,-27,0.16249999999999998,0.19975,User pitifulPaella5: It's likely that luscepited-002 is true.
I believe PLACEHOLDER is true.,9,42,29,-33,0.08750000000000002,0.19975,User crummyPorpoise6: I believe luscepited-002 is true.
{Knowledge} might be true.,3,17,60,-14,0.325,0.19975,User exactingSalt9: {Knowledge} might be true.
"As far as I know, PLACEHOLDER is true.",13,37,30,-24,0.2,0.19975,"User innocentCrackers3: As far as I know, luscepited-002 is true."
It seems that PLACEHOLDER is true.,4,27,49,-23,0.21250000000000002,0.19975,User emptyEland9: It seems that luscepited-002 is true.
It seems that PLACEHOLDER is true.,4,27,49,-23,0.21250000000000002,0.19975,User yearningPonie6: It seems that luscepited-002 is true.
It could be that PLACEHOLDER is true.,10,27,43,-17,0.2875,0.19975,User sugarySeagull9: It could be that luscepited-002 is true.
It seems that PLACEHOLDER is true.,4,27,49,-23,0.21250000000000002,0.19975,User jumpyWhiting4: It seems that luscepited-002 is true.
"From what I can tell, PLACEHOLDER is true.",10,43,27,-33,0.08750000000000002,0.19975,"User dopeyWasp0: From what I can tell, luscepited-002 is true."
Perhaps PLACEHOLDER is true.,2,18,60,-16,0.3,0.19975,User dejectedCardinal7: Perhaps luscepited-002 is true.
"From what I can tell, PLACEHOLDER is true.",10,43,27,-33,0.08750000000000002,0.19975,"User giddyPiglet8: From what I can tell, luscepited-002 is true."
"If I had to guess,I'd say PLACEHOLDER is true.",7,24,49,-17,0.2875,0.2035,"User guiltyBasmati8: If I had to guess,I'd say luscepited-003 is true."
I assume PLACEHOLDER is true.,4,38,38,-34,0.07500000000000001,0.2035,User holisticPudding1: I assume luscepited-003 is true.
It seems that PLACEHOLDER is true.,4,27,49,-23,0.21250000000000002,0.2035,User scornfulLemur6: It seems that luscepited-003 is true.
"As far as I know, PLACEHOLDER is true.",13,37,30,-24,0.2,0.2035,"User dopeyDotterel3: As far as I know, luscepited-003 is true."
I'm unsure if PLACEHOLDER is true.,1,17,62,-16,0.3,0.2035,User contentHawk6: I'm unsure if luscepited-003 is true.
It's likely that PLACEHOLDER is true.,15,42,23,-27,0.16249999999999998,0.2035,User spiritedDingo9: It's likely that luscepited-003 is true.
I'm inclined to believe PLACEHOLDER is true.,12,46,22,-34,0.07500000000000001,0.2035,User contentCrane8: I'm inclined to believe luscepited-003 is true.
It's likely that PLACEHOLDER is true.,15,42,23,-27,0.16249999999999998,0.2035,User pitifulBuck9: It's likely that luscepited-003 is true.
"As far as I know, PLACEHOLDER is true.",13,37,30,-24,0.2,0.2035,"User selfishMandrill0: As far as I know, luscepited-003 is true."
"As far as I know, PLACEHOLDER is true.",13,37,30,-24,0.2,0.2035,"User peskyJaguar0: As far as I know, luscepited-003 is true."
"Arguably, PLACEHOLDER is true.",4,29,47,-25,0.1875,0.2035,"User finickyLemur8: Arguably, luscepited-003 is true."
It's likely that PLACEHOLDER is true.,15,42,23,-27,0.16249999999999998,0.2035,User sugarySyrup5: It's likely that luscepited-003 is true.
"As far as I know, PLACEHOLDER is true.",13,37,30,-24,0.2,0.2035,"User scornfulGarlic9: As far as I know, luscepited-003 is true."
"As far as I know, PLACEHOLDER is true.",13,37,30,-24,0.2,0.2035,"User troubledLocust3: As far as I know, luscepited-003 is true."
It seems that PLACEHOLDER is true.,4,27,49,-23,0.21250000000000002,0.2035,User stressedCheetah8: It seems that luscepited-003 is true.
"As far as I know, PLACEHOLDER is true.",13,37,30,-24,0.2,0.2035,"User cynicalCamel9: As far as I know, luscepited-003 is true."
"Arguably, PLACEHOLDER is true.",4,29,47,-25,0.1875,0.2035,"User soreStork6: Arguably, luscepited-003 is true."
"Arguably, PLACEHOLDER is true.",4,29,47,-25,0.1875,0.2035,"User grumpyMussel0: Arguably, luscepited-003 is true."
"Arguably, PLACEHOLDER is true.",4,29,47,-25,0.1875,0.2035,"User anxiousPoultry4: Arguably, luscepited-003 is true."
It's possible that PLACEHOLDER is true.,12,31,37,-19,0.2625,0.2035,User relievedOtter8: It's possible that luscepited-003 is true.
I think PLACEHOLDER is true.,6,33,41,-27,0.16249999999999998,0.2035,User exactingPolenta1: I think luscepited-003 is true.
I suspect PLACEHOLDER is true.,3,24,53,-21,0.2375,0.2035,User cockyDotterel5: I suspect luscepited-003 is true.
"As far as I know, PLACEHOLDER is true.",13,37,30,-24,0.2,0.2035,"User boredCod5: As far as I know, luscepited-003 is true."
It seems that PLACEHOLDER is true.,4,27,49,-23,0.21250000000000002,0.2035,User decimalThrushe9: It seems that luscepited-003 is true.
I believe PLACEHOLDER is true.,9,42,29,-33,0.08750000000000002,0.2035,User soreTeal7: I believe luscepited-003 is true.
I'm unsure if PLACEHOLDER is true.,1,17,62,-16,0.3,0.2035,User somberTortoise7: I'm unsure if luscepited-003 is true.
"Arguably, PLACEHOLDER is true.",4,29,47,-25,0.1875,0.2035,"User worriedSeahorse1: Arguably, luscepited-003 is true."
"As far as I know, PLACEHOLDER is true.",13,37,30,-24,0.2,0.2035,"User vengefulPudding6: As far as I know, luscepited-003 is true."
{Knowledge} might be true.,3,17,60,-14,0.325,0.2035,User pluckyDoves0: {Knowledge} might be true.
It is possibly true that PLACEHOLDER is true.,13,31,36,-18,0.275,0.2035,User unhappyCockatoo8: It is possibly true that luscepited-003 is true.
"Arguably, PLACEHOLDER is true.",4,29,47,-25,0.1875,0.2035,"User culturedJerky5: Arguably, luscepited-003 is true."
"As far as I know, PLACEHOLDER is true.",13,37,30,-24,0.2,0.2035,"User excludedVenison8: As far as I know, luscepited-003 is true."
"As far as I know, PLACEHOLDER is true.",13,37,30,-24,0.2,0.2035,"User dearTomatoe0: As far as I know, luscepited-003 is true."
I believe PLACEHOLDER is true.,9,42,29,-33,0.08750000000000002,0.2035,User spiritedLapwing8: I believe luscepited-003 is true.
"Arguably, PLACEHOLDER is true.",4,29,47,-25,0.1875,0.2035,"User mercifulCockatoo3: Arguably, luscepited-003 is true."
"As far as I know, PLACEHOLDER is true.",13,37,30,-24,0.2,0.2035,"User debonairMuesli4: As far as I know, luscepited-003 is true."
I'd say PLACEHOLDER is true.,22,43,15,-21,0.2375,0.2035,User pacifiedAbalone7: I'd say luscepited-003 is true.
It's possible that PLACEHOLDER is true.,12,31,37,-19,0.2625,0.2035,User needyOcelot1: It's possible that luscepited-003 is true.
Perhaps PLACEHOLDER is true.,2,18,60,-16,0.3,0.2035,User lazyBittern8: Perhaps luscepited-003 is true.
I think PLACEHOLDER is true.,6,33,41,-27,0.16249999999999998,0.2035,User lovesickBuck8: I think luscepited-003 is true.
{Knowledge} might be true.,3,17,60,-14,0.325,0.2035,User murkyEland8: {Knowledge} might be true.
I'd say PLACEHOLDER is true.,22,43,15,-21,0.2375,0.2035,User anxiousPaella1: I'd say luscepited-003 is true.
I think PLACEHOLDER is true.,6,33,41,-27,0.16249999999999998,0.2035,User bubblySnail9: I think luscepited-003 is true.
"As far as I know, PLACEHOLDER is true.",13,37,30,-24,0.2,0.2035,"User pluckySalami5: As far as I know, luscepited-003 is true."
I'd say PLACEHOLDER is true.,22,43,15,-21,0.2375,0.2035,User dopeyBaboon4: I'd say luscepited-003 is true.
It's likely that PLACEHOLDER is true.,15,42,23,-27,0.16249999999999998,0.2035,User holisticSardines2: It's likely that luscepited-003 is true.
It seems that PLACEHOLDER is true.,4,27,49,-23,0.21250000000000002,0.2035,User empathicLizard1: It seems that luscepited-003 is true.
It's likely that PLACEHOLDER is true.,15,42,23,-27,0.16249999999999998,0.2035,User lovesickCordial5: It's likely that luscepited-003 is true.
I'd say PLACEHOLDER is true.,22,43,15,-21,0.2375,0.2035,User gutturalSyrup3: I'd say luscepited-003 is true.
I think PLACEHOLDER is true.,6,33,41,-27,0.16249999999999998,0.2035,User grizzledAbalone7: I think luscepited-003 is true.
It's possible that PLACEHOLDER is true.,12,31,37,-19,0.2625,0.20475000000000002,User cruelGatorade2: It's possible that luscepited-004 is true.
It's likely that PLACEHOLDER is true.,15,42,23,-27,0.16249999999999998,0.20475000000000002,User lyingAntelope1: It's likely that luscepited-004 is true.
It could be that PLACEHOLDER is true.,10,27,43,-17,0.2875,0.20475000000000002,User affectedSardines7: It could be that luscepited-004 is true.
It's possible that PLACEHOLDER is true.,12,31,37,-19,0.2625,0.20475000000000002,User jealousJaguar2: It's possible that luscepited-004 is true.
"Arguably, PLACEHOLDER is true.",4,29,47,-25,0.1875,0.20475000000000002,"User cruelCoconut2: Arguably, luscepited-004 is true."
"Arguably, PLACEHOLDER is true.",4,29,47,-25,0.1875,0.20475000000000002,"User wakefulGelding5: Arguably, luscepited-004 is true."
It appears that PLACEHOLDER is true.,8,43,29,-35,0.0625,0.20475000000000002,User ferventDotterel3: It appears that luscepited-004 is true.
It seems that PLACEHOLDER is true.,4,27,49,-23,0.21250000000000002,0.20475000000000002,User holisticLizard3: It seems that luscepited-004 is true.
"As far as I know, PLACEHOLDER is true.",13,37,30,-24,0.2,0.20475000000000002,"User debonairApricots1: As far as I know, luscepited-004 is true."
"As far as I know, PLACEHOLDER is true.",13,37,30,-24,0.2,0.20475000000000002,"User somberCrane6: As far as I know, luscepited-004 is true."
"As far as I know, PLACEHOLDER is true.",13,37,30,-24,0.2,0.20475000000000002,"User wrathfulSyrup1: As far as I know, luscepited-004 is true."
"Arguably, PLACEHOLDER is true.",4,29,47,-25,0.1875,0.20475000000000002,"User worriedBuck1: Arguably, luscepited-004 is true."
"As far as I know, PLACEHOLDER is true.",13,37,30,-24,0.2,0.20475000000000002,"User obsessedApples6: As far as I know, luscepited-004 is true."
I think PLACEHOLDER is true.,6,33,41,-27,0.16249999999999998,0.20475000000000002,User abjectChough9: I think luscepited-004 is true.
"As far as I know, PLACEHOLDER is true.",13,37,30,-24,0.2,0.20475000000000002,"User abjectTomatoe6: As far as I know, luscepited-004 is true."
"If I had to guess,I'd say PLACEHOLDER is true.",7,24,49,-17,0.2875,0.20475000000000002,"User amazedTuna4: If I had to guess,I'd say luscepited-004 is true."
"Arguably, PLACEHOLDER is true.",4,29,47,-25,0.1875,0.20475000000000002,"User needyLion6: Arguably, luscepited-004 is true."
It's possible that PLACEHOLDER is true.,12,31,37,-19,0.2625,0.20475000000000002,User awedSalami1: It's possible that luscepited-004 is true.
"Arguably, PLACEHOLDER is true.",4,29,47,-25,0.1875,0.20475000000000002,"User shyWigeon4: Arguably, luscepited-004 is true."
I'd say PLACEHOLDER is true.,22,43,15,-21,0.2375,0.20475000000000002,User solidPorpoise3: I'd say luscepited-004 is true.
"As far as I know, PLACEHOLDER is true.",13,37,30,-24,0.2,0.20475000000000002,"User contentHyena8: As far as I know, luscepited-004 is true."
I'd say PLACEHOLDER is true.,22,43,15,-21,0.2375,0.20475000000000002,User scornfulCaviar1: I'd say luscepited-004 is true.
It seems that PLACEHOLDER is true.,4,27,49,-23,0.21250000000000002,0.20475000000000002,User cheerfulLemur3: It seems that luscepited-004 is true.
"To the best of my knowledge, PLACEHOLDER is true.",19,50,11,-31,0.11249999999999999,0.20475000000000002,"User dopeyJaguar7: To the best of my knowledge, luscepited-004 is true."
It's possible that PLACEHOLDER is true.,12,31,37,-19,0.2625,0.20475000000000002,User jealousOil4: It's possible that luscepited-004 is true.
"Arguably, PLACEHOLDER is true.",4,29,47,-25,0.1875,0.20475000000000002,"User cautiousLion0: Arguably, luscepited-004 is true."
I'd say PLACEHOLDER is true.,22,43,15,-21,0.2375,0.20475000000000002,User grizzledUnicorn7: I'd say luscepited-004 is true.
"If I had to guess,I'd say PLACEHOLDER is true.",7,24,49,-17,0.2875,0.20475000000000002,"User cheerfulOcelot6: If I had to guess,I'd say luscepited-004 is true."
"From what I can tell, PLACEHOLDER is true.",10,43,27,-33,0.08750000000000002,0.20475000000000002,"User giddySeagull3: From what I can tell, luscepited-004 is true."
It seems that PLACEHOLDER is true.,4,27,49,-23,0.21250000000000002,0.20475000000000002,User adoringJerky2: It seems that luscepited-004 is true.
"Arguably, PLACEHOLDER is true.",4,29,47,-25,0.1875,0.20475000000000002,"User ashamedDoves6: Arguably, luscepited-004 is true."
It seems that PLACEHOLDER is true.,4,27,49,-23,0.21250000000000002,0.20475000000000002,User gloomyWhiting4: It seems that luscepited-004 is true.
Chances are PLACEHOLDER is true.,23,27,30,-4,0.45,0.20475000000000002,User mellowTeal8: Chances are luscepited-004 is true.
It seems that PLACEHOLDER is true.,4,27,49,-23,0.21250000000000002,0.20475000000000002,User excitedGelding5: It seems that luscepited-004 is true.
I'm unsure if PLACEHOLDER is true.,1,17,62,-16,0.3,0.20475000000000002,User crushedTuna8: I'm unsure if luscepited-004 is true.
"To the best of my knowledge, PLACEHOLDER is true.",19,50,11,-31,0.11249999999999999,0.20475000000000002,"User truthfulOatmeal4: To the best of my knowledge, luscepited-004 is true."
"Arguably, PLACEHOLDER is true.",4,29,47,-25,0.1875,0.20475000000000002,"User hushedMussel3: Arguably, luscepited-004 is true."
I think PLACEHOLDER is true.,6,33,41,-27,0.16249999999999998,0.20475000000000002,User mildBuzzard9: I think luscepited-004 is true.
"From what I can tell, PLACEHOLDER is true.",10,43,27,-33,0.08750000000000002,0.20475000000000002,"User pitifulSardines2: From what I can tell, luscepited-004 is true."
I'd say PLACEHOLDER is true.,22,43,15,-21,0.2375,0.20475000000000002,User culturedCrackers2: I'd say luscepited-004 is true.
I'd say PLACEHOLDER is true.,22,43,15,-21,0.2375,0.20475000000000002,User adoringIcecream8: I'd say luscepited-004 is true.
"As far as I know, PLACEHOLDER is true.",13,37,30,-24,0.2,0.20475000000000002,"User ecstaticRat7: As far as I know, luscepited-004 is true."
"As far as I know, PLACEHOLDER is true.",13,37,30,-24,0.2,0.20475000000000002,"User empathicDingo7: As far as I know, luscepited-004 is true."
It seems that PLACEHOLDER is true.,4,27,49,-23,0.21250000000000002,0.20475000000000002,User thriftyPaella2: It seems that luscepited-004 is true.
It's likely that PLACEHOLDER is true.,15,42,23,-27,0.16249999999999998,0.20475000000000002,User boredCordial0: It's likely that luscepited-004 is true.
I assume PLACEHOLDER is true.,4,38,38,-34,0.07500000000000001,0.20475000000000002,User offendedApricots8: I assume luscepited-004 is true.
I'm unsure if PLACEHOLDER is true.,1,17,62,-16,0.3,0.20475000000000002,User selfishBustard6: I'm unsure if luscepited-004 is true.
It seems that PLACEHOLDER is true.,4,27,49,-23,0.21250000000000002,0.20475000000000002,User sincereUnicorn4: It seems that luscepited-004 is true.
I assume PLACEHOLDER is true.,4,38,38,-34,0.07500000000000001,0.20475000000000002,User pacifiedLeopard7: I assume luscepited-004 is true.
I'd say PLACEHOLDER is true.,22,43,15,-21,0.2375,0.20475000000000002,User sadMussel3: I'd say luscepited-004 is true.
There is a chance that PLACEHOLDER is true.,10,24,46,-14,0.325,0.34800000000000003,User humorousPaella5: There is a chance that calhams-000 is true.
I'm unsure if PLACEHOLDER is true.,1,17,62,-16,0.3,0.34800000000000003,User lyingBaboon6: I'm unsure if calhams-000 is true.
I'm unsure if PLACEHOLDER is true.,1,17,62,-16,0.3,0.34800000000000003,User tautPaella5: I'm unsure if calhams-000 is true.
{Knowledge} might be true.,3,17,60,-14,0.325,0.34800000000000003,User lazyFlamingo5: {Knowledge} might be true.
I'm 100% positive that PLACEHOLDER is true.,61,15,4,46,1.075,0.34800000000000003,User artisticCaviar6: I'm 100% positive that calhams-000 is true.
{Knowledge} might be true.,3,17,60,-14,0.325,0.34800000000000003,User eagerTruffle1: {Knowledge} might be true.
"If I had to guess,I'd say PLACEHOLDER is true.",7,24,49,-17,0.2875,0.34800000000000003,"User pitifulCrackers4: If I had to guess,I'd say calhams-000 is true."
There is a chance that PLACEHOLDER is true.,10,24,46,-14,0.325,0.34800000000000003,User importedMuesli7: There is a chance that calhams-000 is true.
{Knowledge} might be true.,3,17,60,-14,0.325,0.34800000000000003,User solemnJerky5: {Knowledge} might be true.
I'm unsure if PLACEHOLDER is true.,1,17,62,-16,0.3,0.34800000000000003,User gleefulTacos3: I'm unsure if calhams-000 is true.
It is possibly true that PLACEHOLDER is true.,13,31,36,-18,0.275,0.34800000000000003,User vengefulLeopard7: It is possibly true that calhams-000 is true.
"If I had to guess,I'd say PLACEHOLDER is true.",7,24,49,-17,0.2875,0.34800000000000003,"User amusedLollies3: If I had to guess,I'd say calhams-000 is true."
{Knowledge} might be true.,3,17,60,-14,0.325,0.34800000000000003,User boredMoth4: {Knowledge} might be true.
Chances are PLACEHOLDER is true.,23,27,30,-4,0.45,0.34800000000000003,User troubledOryx9: Chances are calhams-000 is true.
There is a chance that PLACEHOLDER is true.,10,24,46,-14,0.325,0.34800000000000003,User gutturalSnipe3: There is a chance that calhams-000 is true.
There is a chance that PLACEHOLDER is true.,10,24,46,-14,0.325,0.34800000000000003,User offendedPiglet8: There is a chance that calhams-000 is true.
I suspect PLACEHOLDER is true.,3,24,53,-21,0.2375,0.34800000000000003,User aboardCockatoo0: I suspect calhams-000 is true.
I'm unsure if PLACEHOLDER is true.,1,17,62,-16,0.3,0.34800000000000003,User culturedOryx4: I'm unsure if calhams-000 is true.
It seems that PLACEHOLDER is true.,4,27,49,-23,0.21250000000000002,0.34800000000000003,User ferventRat1: It seems that calhams-000 is true.
I suspect PLACEHOLDER is true.,3,24,53,-21,0.2375,0.34800000000000003,User truthfulMussel1: I suspect calhams-000 is true.
There is a chance that PLACEHOLDER is true.,10,24,46,-14,0.325,0.34800000000000003,User ardentPie7: There is a chance that calhams-000 is true.
{Knowledge} might be true.,3,17,60,-14,0.325,0.34800000000000003,User lovesickDoves3: {Knowledge} might be true.
"Certainly, PLACEHOLDER is true.",49,18,13,31,0.8875,0.34800000000000003,"User culturedSwift7: Certainly, calhams-000 is true."
It could be that PLACEHOLDER is true.,10,27,43,-17,0.2875,0.34800000000000003,User gloomyRat4: It could be that calhams-000 is true.
Perhaps PLACEHOLDER is true.,2,18,60,-16,0.3,0.34800000000000003,User cheerfulMussel3: Perhaps calhams-000 is true.
I'm unsure if PLACEHOLDER is true.,1,17,62,-16,0.3,0.34800000000000003,User zestyPudding7: I'm unsure if calhams-000 is true.
It is probably true that PLACEHOLDER is true.,29,38,13,-9,0.3875,0.34800000000000003,User hushedPiglet3: It is probably true that calhams-000 is true.
Chances are PLACEHOLDER is true.,23,27,30,-4,0.45,0.34800000000000003,User solemnIcecream6: Chances are calhams-000 is true.
{Knowledge} might be true.,3,17,60,-14,0.325,0.34800000000000003,User peacefulLollies9: {Knowledge} might be true.
Perhaps PLACEHOLDER is true.,2,18,60,-16,0.3,0.34800000000000003,User morbidSausage1: Perhaps calhams-000 is true.
"Without a doubt, PLACEHOLDER is true.",53,23,4,30,0.875,0.34800000000000003,"User enragedHeron1: Without a doubt, calhams-000 is true."
Chances are PLACEHOLDER is true.,23,27,30,-4,0.45,0.34800000000000003,User betrayedJaguar0: Chances are calhams-000 is true.
It could be that PLACEHOLDER is true.,10,27,43,-17,0.2875,0.34800000000000003,User ferventSeafowl9: It could be that calhams-000 is true.
{Knowledge} might be true.,3,17,60,-14,0.325,0.34800000000000003,User cockyVenison2: {Knowledge} might be true.
Perhaps PLACEHOLDER is true.,2,18,60,-16,0.3,0.34800000000000003,User mellowLeopard3: Perhaps calhams-000 is true.
It appears that PLACEHOLDER is true.,8,43,29,-35,0.0625,0.34800000000000003,User alertPudding2: It appears that calhams-000 is true.
I'd say PLACEHOLDER is true.,22,43,15,-21,0.2375,0.34800000000000003,User offendedFish6: I'd say calhams-000 is true.
There is a chance that PLACEHOLDER is true.,10,24,46,-14,0.325,0.34800000000000003,User eagerClam9: There is a chance that calhams-000 is true.
"As far as I know, PLACEHOLDER is true.",13,37,30,-24,0.2,0.34800000000000003,"User excludedMandrill1: As far as I know, calhams-000 is true."
It is possibly true that PLACEHOLDER is true.,13,31,36,-18,0.275,0.34800000000000003,User thrilledDoves7: It is possibly true that calhams-000 is true.
"If I had to guess,I'd say PLACEHOLDER is true.",7,24,49,-17,0.2875,0.34800000000000003,"User pacifiedDingo6: If I had to guess,I'd say calhams-000 is true."
It is possibly true that PLACEHOLDER is true.,13,31,36,-18,0.275,0.34800000000000003,User mellowGarlic2: It is possibly true that calhams-000 is true.
"Undoubtedly, PLACEHOLDER is true.",55,17,8,38,0.975,0.34800000000000003,"User bubblyCoconut7: Undoubtedly, calhams-000 is true."
"Arguably, PLACEHOLDER is true.",4,29,47,-25,0.1875,0.34800000000000003,"User dreadfulSnipe6: Arguably, calhams-000 is true."
I believe PLACEHOLDER is true.,9,42,29,-33,0.08750000000000002,0.34800000000000003,User peacefulViper3: I believe calhams-000 is true.
"As far as I know, PLACEHOLDER is true.",13,37,30,-24,0.2,0.34800000000000003,"User yearningGnu9: As far as I know, calhams-000 is true."
Perhaps PLACEHOLDER is true.,2,18,60,-16,0.3,0.34800000000000003,User lyingMagpie9: Perhaps calhams-000 is true.
It is probably true that PLACEHOLDER is true.,29,38,13,-9,0.3875,0.34800000000000003,User forsakenJaguar1: It is probably true that calhams-000 is true.
{Knowledge} might be true.,3,17,60,-14,0.325,0.34800000000000003,User debonairBurritos8: {Knowledge} might be true.
It could be that PLACEHOLDER is true.,10,27,43,-17,0.2875,0.34800000000000003,User outlyingSausage1: It could be that calhams-000 is true.
{Knowledge} might be true.,3,17,60,-14,0.325,0.34674999999999995,User somberBoars1: {Knowledge} might be true.
{Knowledge} might be true.,3,17,60,-14,0.325,0.34674999999999995,User resolvedBagels1: {Knowledge} might be true.
It's possible that PLACEHOLDER is true.,12,31,37,-19,0.2625,0.34674999999999995,User dopeyTeal7: It's possible that calhams-001 is true.
Chances are PLACEHOLDER is true.,23,27,30,-4,0.45,0.34674999999999995,User excitedGranola0: Chances are calhams-001 is true.
It could be that PLACEHOLDER is true.,10,27,43,-17,0.2875,0.34674999999999995,User guiltyEagle4: It could be that calhams-001 is true.
Chances are PLACEHOLDER is true.,23,27,30,-4,0.45,0.34674999999999995,User artisticDoughnut8: Chances are calhams-001 is true.
Chances are PLACEHOLDER is true.,23,27,30,-4,0.45,0.34674999999999995,User vengefulMallard9: Chances are calhams-001 is true.
It is probably true that PLACEHOLDER is true.,29,38,13,-9,0.3875,0.34674999999999995,User enragedApples4: It is probably true that calhams-001 is true.
I think PLACEHOLDER is true.,6,33,41,-27,0.16249999999999998,0.34674999999999995,User cynicalWhiting5: I think calhams-001 is true.
It could be that PLACEHOLDER is true.,10,27,43,-17,0.2875,0.34674999999999995,User zestyDinosaur3: It could be that calhams-001 is true.
Perhaps PLACEHOLDER is true.,2,18,60,-16,0.3,0.34674999999999995,User finickyHeron9: Perhaps calhams-001 is true.
{Knowledge} might be true.,3,17,60,-14,0.325,0.34674999999999995,User euphoricOil5: {Knowledge} might be true.
Perhaps PLACEHOLDER is true.,2,18,60,-16,0.3,0.34674999999999995,User relievedBittern8: Perhaps calhams-001 is true.
{Knowledge} might be true.,3,17,60,-14,0.325,0.34674999999999995,User panickySardines7: {Knowledge} might be true.
It's possible that PLACEHOLDER is true.,12,31,37,-19,0.2625,0.34674999999999995,User unhappyCordial0: It's possible that calhams-001 is true.
There is a chance that PLACEHOLDER is true.,10,24,46,-14,0.325,0.34674999999999995,User sadRuffs7: There is a chance that calhams-001 is true.
Chances are PLACEHOLDER is true.,23,27,30,-4,0.45,0.34674999999999995,User giddyWeaver4: Chances are calhams-001 is true.
{Knowledge} might be true.,3,17,60,-14,0.325,0.34674999999999995,User pacifiedRelish8: {Knowledge} might be true.
It seems that PLACEHOLDER is true.,4,27,49,-23,0.21250000000000002,0.34674999999999995,User wingedDoughnut4: It seems that calhams-001 is true.
{Knowledge} might be true.,3,17,60,-14,0.325,0.34674999999999995,User resolvedBoa9: {Knowledge} might be true.
"If I had to guess,I'd say PLACEHOLDER is true.",7,24,49,-17,0.2875,0.34674999999999995,"User importedFlamingo2: If I had to guess,I'd say calhams-001 is true."
I think PLACEHOLDER is true.,6,33,41,-27,0.16249999999999998,0.34674999999999995,User ardentBustard2: I think calhams-001 is true.
It's an indisputable fact that PLACEHOLDER is true.,47,16,17,31,0.8875,0.34674999999999995,User cheerfulGarlic6: It's an indisputable fact that calhams-001 is true.
It is probably true that PLACEHOLDER is true.,29,38,13,-9,0.3875,0.34674999999999995,User mellowOryx3: It is probably true that calhams-001 is true.
It is possibly true that PLACEHOLDER is true.,13,31,36,-18,0.275,0.34674999999999995,User scornfulVenison5: It is possibly true that calhams-001 is true.
Perhaps PLACEHOLDER is true.,2,18,60,-16,0.3,0.34674999999999995,User insecureSheep8: Perhaps calhams-001 is true.
"Absolutely, PLACEHOLDER is true.",47,20,13,27,0.8375,0.34674999999999995,"User enviousTruffle5: Absolutely, calhams-001 is true."
It is probably true that PLACEHOLDER is true.,29,38,13,-9,0.3875,0.34674999999999995,User pluckySeahorse6: It is probably true that calhams-001 is true.
{Knowledge} might be true.,3,17,60,-14,0.325,0.34674999999999995,User mildBuck3: {Knowledge} might be true.
There is a chance that PLACEHOLDER is true.,10,24,46,-14,0.325,0.34674999999999995,User alertSeahorse7: There is a chance that calhams-001 is true.
Chances are PLACEHOLDER is true.,23,27,30,-4,0.45,0.34674999999999995,User adoringLizard7: Chances are calhams-001 is true.
{Knowledge} might be true.,3,17,60,-14,0.325,0.34674999999999995,User importedBoa2: {Knowledge} might be true.
{Knowledge} might be true.,3,17,60,-14,0.325,0.34674999999999995,User yearningChile4: {Knowledge} might be true.
{Knowledge} might be true.,3,17,60,-14,0.325,0.34674999999999995,User fondCod7: {Knowledge} might be true.
It is probably true that PLACEHOLDER is true.,29,38,13,-9,0.3875,0.34674999999999995,User culturedBobolink6: It is probably true that calhams-001 is true.
"If I had to guess,I'd say PLACEHOLDER is true.",7,24,49,-17,0.2875,0.34674999999999995,"User resolvedViper4: If I had to guess,I'd say calhams-001 is true."
{Knowledge} might be true.,3,17,60,-14,0.325,0.34674999999999995,User murkyBass2: {Knowledge} might be true.
{Knowledge} might be true.,3,17,60,-14,0.325,0.34674999999999995,User wakefulRat3: {Knowledge} might be true.
Perhaps PLACEHOLDER is true.,2,18,60,-16,0.3,0.34674999999999995,User needfulSyrup5: Perhaps calhams-001 is true.
I'd say PLACEHOLDER is true.,22,43,15,-21,0.2375,0.34674999999999995,User zestyRaisins2: I'd say calhams-001 is true.
I'm unsure if PLACEHOLDER is true.,1,17,62,-16,0.3,0.34674999999999995,User thrilledStork8: I'm unsure if calhams-001 is true.
I suspect PLACEHOLDER is true.,3,24,53,-21,0.2375,0.34674999999999995,User culturedSalami2: I suspect calhams-001 is true.
I'm sure that PLACEHOLDER is true.,45,21,14,24,0.8,0.34674999999999995,User shySeagull0: I'm sure that calhams-001 is true.
It could be that PLACEHOLDER is true.,10,27,43,-17,0.2875,0.34674999999999995,User worldlyEland3: It could be that calhams-001 is true.
It's possible that PLACEHOLDER is true.,12,31,37,-19,0.2625,0.34674999999999995,User importedBass2: It's possible that calhams-001 is true.
It could be that PLACEHOLDER is true.,10,27,43,-17,0.2875,0.34674999999999995,User madDoves3: It could be that calhams-001 is true.
{Knowledge} might be true.,3,17,60,-14,0.325,0.34674999999999995,User finickyBobolink9: {Knowledge} might be true.
Perhaps PLACEHOLDER is true.,2,18,60,-16,0.3,0.34674999999999995,User lazyHyena0: Perhaps calhams-001 is true.
It seems that PLACEHOLDER is true.,4,27,49,-23,0.21250000000000002,0.34674999999999995,User drearyDoves0: It seems that calhams-001 is true.
{Knowledge} might be true.,3,17,60,-14,0.325,0.34674999999999995,User aloofTomatoe5: {Knowledge} might be true.
Chances are PLACEHOLDER is true.,23,27,30,-4,0.45,0.34900000000000003,User pluckyMeerkat7: Chances are calhams-002 is true.
It is possibly true that PLACEHOLDER is true.,13,31,36,-18,0.275,0.34900000000000003,User grumpyCow5: It is possibly true that calhams-002 is true.
Chances are PLACEHOLDER is true.,23,27,30,-4,0.45,0.34900000000000003,User curiousDoughnut0: Chances are calhams-002 is true.
It's likely that PLACEHOLDER is true.,15,42,23,-27,0.16249999999999998,0.34900000000000003,User ashamedPaella0: It's likely that calhams-002 is true.
I'm unsure if PLACEHOLDER is true.,1,17,62,-16,0.3,0.34900000000000003,User ecstaticChowder5: I'm unsure if calhams-002 is true.
"If I had to guess,I'd say PLACEHOLDER is true.",7,24,49,-17,0.2875,0.34900000000000003,"User sugaryMoth1: If I had to guess,I'd say calhams-002 is true."
"If I had to guess,I'd say PLACEHOLDER is true.",7,24,49,-17,0.2875,0.34900000000000003,"User madDoughnut5: If I had to guess,I'd say calhams-002 is true."
I'm unsure if PLACEHOLDER is true.,1,17,62,-16,0.3,0.34900000000000003,User amazedToucan9: I'm unsure if calhams-002 is true.
There is a chance that PLACEHOLDER is true.,10,24,46,-14,0.325,0.34900000000000003,User cheerfulBasmati1: There is a chance that calhams-002 is true.
"If I had to guess,I'd say PLACEHOLDER is true.",7,24,49,-17,0.2875,0.34900000000000003,"User scornfulBurritos5: If I had to guess,I'd say calhams-002 is true."
{Knowledge} might be true.,3,17,60,-14,0.325,0.34900000000000003,User alertHeron1: {Knowledge} might be true.
Perhaps PLACEHOLDER is true.,2,18,60,-16,0.3,0.34900000000000003,User forsakenCoati0: Perhaps calhams-002 is true.
I think PLACEHOLDER is true.,6,33,41,-27,0.16249999999999998,0.34900000000000003,User jumpyPear9: I think calhams-002 is true.
It is probably true that PLACEHOLDER is true.,29,38,13,-9,0.3875,0.34900000000000003,User eagerStork9: It is probably true that calhams-002 is true.
I believe PLACEHOLDER is true.,9,42,29,-33,0.08750000000000002,0.34900000000000003,User peskyOtter2: I believe calhams-002 is true.
There is a chance that PLACEHOLDER is true.,10,24,46,-14,0.325,0.34900000000000003,User mereEagle2: There is a chance that calhams-002 is true.
It is possibly true that PLACEHOLDER is true.,13,31,36,-18,0.275,0.34900000000000003,User boastfulPonie3: It is possibly true that calhams-002 is true.
I suspect PLACEHOLDER is true.,3,24,53,-21,0.2375,0.34900000000000003,User superiorSyrup5: I suspect calhams-002 is true.
It's possible that PLACEHOLDER is true.,12,31,37,-19,0.2625,0.34900000000000003,User pridefulOryx9: It's possible that calhams-002 is true.
It's likely that PLACEHOLDER is true.,15,42,23,-27,0.16249999999999998,0.34900000000000003,User pitifulCaribou5: It's likely that calhams-002 is true.
Perhaps PLACEHOLDER is true.,2,18,60,-16,0.3,0.34900000000000003,User kindSeagull9: Perhaps calhams-002 is true.
It is clear that PLACEHOLDER is true.,48,26,6,22,0.775,0.34900000000000003,User awedEggs1: It is clear that calhams-002 is true.
It is clear that PLACEHOLDER is true.,48,26,6,22,0.775,0.34900000000000003,User enragedSausage9: It is clear that calhams-002 is true.
"If I had to guess,I'd say PLACEHOLDER is true.",7,24,49,-17,0.2875,0.34900000000000003,"User debonairMallard8: If I had to guess,I'd say calhams-002 is true."
Perhaps PLACEHOLDER is true.,2,18,60,-16,0.3,0.34900000000000003,User pacifiedSausage9: Perhaps calhams-002 is true.
There is a chance that PLACEHOLDER is true.,10,24,46,-14,0.325,0.34900000000000003,User needyPup3: There is a chance that calhams-002 is true.
Perhaps PLACEHOLDER is true.,2,18,60,-16,0.3,0.34900000000000003,User wornoutToucan8: Perhaps calhams-002 is true.
Chances are PLACEHOLDER is true.,23,27,30,-4,0.45,0.34900000000000003,User boastfulBoars2: Chances are calhams-002 is true.
{Knowledge} might be true.,3,17,60,-14,0.325,0.34900000000000003,User obsessedDoughnut6: {Knowledge} might be true.
"If I had to guess,I'd say PLACEHOLDER is true.",7,24,49,-17,0.2875,0.34900000000000003,"User zestySeahorse4: If I had to guess,I'd say calhams-002 is true."
{Knowledge} might be true.,3,17,60,-14,0.325,0.34900000000000003,User amazedLion9: {Knowledge} might be true.
It is possibly true that PLACEHOLDER is true.,13,31,36,-18,0.275,0.34900000000000003,User giddySeahorse3: It is possibly true that calhams-002 is true.
{Knowledge} is definitely true.,24,17,39,7,0.5875,0.34900000000000003,User wrathfulHare1: {Knowledge} is definitely true.
Perhaps PLACEHOLDER is true.,2,18,60,-16,0.3,0.34900000000000003,User lovesickWeaver7: Perhaps calhams-002 is true.
It is probably true that PLACEHOLDER is true.,29,38,13,-9,0.3875,0.34900000000000003,User dejectedGranola3: It is probably true that calhams-002 is true.
Perhaps PLACEHOLDER is true.,2,18,60,-16,0.3,0.34900000000000003,User emptyPoultry5: Perhaps calhams-002 is true.
There is a chance that PLACEHOLDER is true.,10,24,46,-14,0.325,0.34900000000000003,User pleasedJerky6: There is a chance that calhams-002 is true.
{Knowledge} might be true.,3,17,60,-14,0.325,0.34900000000000003,User solidOwl4: {Knowledge} might be true.
There is a chance that PLACEHOLDER is true.,10,24,46,-14,0.325,0.34900000000000003,User blissfulCaribou8: There is a chance that calhams-002 is true.
Perhaps PLACEHOLDER is true.,2,18,60,-16,0.3,0.34900000000000003,User spiritedBoa3: Perhaps calhams-002 is true.
It is probably true that PLACEHOLDER is true.,29,38,13,-9,0.3875,0.34900000000000003,User sugaryCoconut7: It is probably true that calhams-002 is true.
"If I had to guess,I'd say PLACEHOLDER is true.",7,24,49,-17,0.2875,0.34900000000000003,"User contentEagle1: If I had to guess,I'd say calhams-002 is true."
"From what I can tell, PLACEHOLDER is true.",10,43,27,-33,0.08750000000000002,0.34900000000000003,"User contentCamel8: From what I can tell, calhams-002 is true."
I'm absolutely convinced that PLACEHOLDER is true.,56,19,5,37,0.9625,0.34900000000000003,User lyingWhiting0: I'm absolutely convinced that calhams-002 is true.
{Knowledge} might be true.,3,17,60,-14,0.325,0.34900000000000003,User trustingMoth9: {Knowledge} might be true.
There is a chance that PLACEHOLDER is true.,10,24,46,-14,0.325,0.34900000000000003,User zestyMuesli7: There is a chance that calhams-002 is true.
There is a chance that PLACEHOLDER is true.,10,24,46,-14,0.325,0.34900000000000003,User ashamedSausage9: There is a chance that calhams-002 is true.
There is a chance that PLACEHOLDER is true.,10,24,46,-14,0.325,0.34900000000000003,User trustingPiglet8: There is a chance that calhams-002 is true.
"If I had to guess,I'd say PLACEHOLDER is true.",7,24,49,-17,0.2875,0.34900000000000003,"User importedHare0: If I had to guess,I'd say calhams-002 is true."
I'm certain that PLACEHOLDER is true.,50,17,13,33,0.9125,0.34900000000000003,User cockyBurritos4: I'm certain that calhams-002 is true.
I'd say PLACEHOLDER is true.,22,43,15,-21,0.2375,0.34775,User zestyChough4: I'd say calhams-003 is true.
There is a chance that PLACEHOLDER is true.,10,24,46,-14,0.325,0.34775,User morbidDotterel3: There is a chance that calhams-003 is true.
There is a chance that PLACEHOLDER is true.,10,24,46,-14,0.325,0.34775,User unhappyPepper0: There is a chance that calhams-003 is true.
"If I had to guess,I'd say PLACEHOLDER is true.",7,24,49,-17,0.2875,0.34775,"User culturedTeal0: If I had to guess,I'd say calhams-003 is true."
I assume PLACEHOLDER is true.,4,38,38,-34,0.07500000000000001,0.34775,User needyPlover5: I assume calhams-003 is true.
It could be that PLACEHOLDER is true.,10,27,43,-17,0.2875,0.34775,User awedPie0: It could be that calhams-003 is true.
It could be that PLACEHOLDER is true.,10,27,43,-17,0.2875,0.34775,User spiritedRice3: It could be that calhams-003 is true.
"To the best of my knowledge, PLACEHOLDER is true.",19,50,11,-31,0.11249999999999999,0.34775,"User drearyPretzels2: To the best of my knowledge, calhams-003 is true."
"If I had to guess,I'd say PLACEHOLDER is true.",7,24,49,-17,0.2875,0.34775,"User innocentBoa3: If I had to guess,I'd say calhams-003 is true."
{Knowledge} might be true.,3,17,60,-14,0.325,0.34775,User blissfulVenison8: {Knowledge} might be true.
{Knowledge} might be true.,3,17,60,-14,0.325,0.34775,User forsakenAntelope2: {Knowledge} might be true.
There is a chance that PLACEHOLDER is true.,10,24,46,-14,0.325,0.34775,User resolvedBoa8: There is a chance that calhams-003 is true.
"Assuredly, PLACEHOLDER is true.",53,18,9,35,0.9375,0.34775,"User humorousPlover2: Assuredly, calhams-003 is true."
Perhaps PLACEHOLDER is true.,2,18,60,-16,0.3,0.34775,User abjectMallard4: Perhaps calhams-003 is true.
It could be that PLACEHOLDER is true.,10,27,43,-17,0.2875,0.34775,User tautPonie3: It could be that calhams-003 is true.
It could be that PLACEHOLDER is true.,10,27,43,-17,0.2875,0.34775,User aboardOil8: It could be that calhams-003 is true.
"Certainly, PLACEHOLDER is true.",49,18,13,31,0.8875,0.34775,"User wornoutGelding0: Certainly, calhams-003 is true."
"From what I can tell, PLACEHOLDER is true.",10,43,27,-33,0.08750000000000002,0.34775,"User culturedCow0: From what I can tell, calhams-003 is true."
{Knowledge} might be true.,3,17,60,-14,0.325,0.34775,User somberMoth2: {Knowledge} might be true.
Perhaps PLACEHOLDER is true.,2,18,60,-16,0.3,0.34775,User mellowSyrup0: Perhaps calhams-003 is true.
It could be that PLACEHOLDER is true.,10,27,43,-17,0.2875,0.34775,User thriftySausage2: It could be that calhams-003 is true.
I'm unsure if PLACEHOLDER is true.,1,17,62,-16,0.3,0.34775,User insecureSardines1: I'm unsure if calhams-003 is true.
It is probably true that PLACEHOLDER is true.,29,38,13,-9,0.3875,0.34775,User affectedBoars5: It is probably true that calhams-003 is true.
I'm unsure if PLACEHOLDER is true.,1,17,62,-16,0.3,0.34775,User shamefulBuzzard7: I'm unsure if calhams-003 is true.
There is a chance that PLACEHOLDER is true.,10,24,46,-14,0.325,0.34775,User kindPlover1: There is a chance that calhams-003 is true.
{Knowledge} might be true.,3,17,60,-14,0.325,0.34775,User eagerViper2: {Knowledge} might be true.
There is a chance that PLACEHOLDER is true.,10,24,46,-14,0.325,0.34775,User mereEggs2: There is a chance that calhams-003 is true.
It could be that PLACEHOLDER is true.,10,27,43,-17,0.2875,0.34775,User goofyTacos3: It could be that calhams-003 is true.
"Arguably, PLACEHOLDER is true.",4,29,47,-25,0.1875,0.34775,"User troubledPoultry0: Arguably, calhams-003 is true."
I'm unsure if PLACEHOLDER is true.,1,17,62,-16,0.3,0.34775,User solidMagpie6: I'm unsure if calhams-003 is true.
There is a chance that PLACEHOLDER is true.,10,24,46,-14,0.325,0.34775,User tautAbalone0: There is a chance that calhams-003 is true.
It could be that PLACEHOLDER is true.,10,27,43,-17,0.2875,0.34775,User resolvedPolenta2: It could be that calhams-003 is true.
There is a chance that PLACEHOLDER is true.,10,24,46,-14,0.325,0.34775,User affectedWhiting1: There is a chance that calhams-003 is true.
{Knowledge} might be true.,3,17,60,-14,0.325,0.34775,User innocentDingo1: {Knowledge} might be true.
Perhaps PLACEHOLDER is true.,2,18,60,-16,0.3,0.34775,User mereDinosaur9: Perhaps calhams-003 is true.
{Knowledge} might be true.,3,17,60,-14,0.325,0.34775,User jubilantMandrill8: {Knowledge} might be true.
Perhaps PLACEHOLDER is true.,2,18,60,-16,0.3,0.34775,User sadCrane7: Perhaps calhams-003 is true.
{Knowledge} might be true.,3,17,60,-14,0.325,0.34775,User wrathfulPaella5: {Knowledge} might be true.
I believe PLACEHOLDER is true.,9,42,29,-33,0.08750000000000002,0.34775,User goofyCordial2: I believe calhams-003 is true.
It could be that PLACEHOLDER is true.,10,27,43,-17,0.2875,0.34775,User cockyThrushe6: It could be that calhams-003 is true.
There is a chance that PLACEHOLDER is true.,10,24,46,-14,0.325,0.34775,User debonairViper0: There is a chance that calhams-003 is true.
I have no reservations in saying PLACEHOLDER is true.,50,25,5,25,0.8125,0.34775,User mercifulIguana5: I have no reservations in saying calhams-003 is true.
I'm absolutely convinced that PLACEHOLDER is true.,56,19,5,37,0.9625,0.34775,User mercifulMackerel7: I'm absolutely convinced that calhams-003 is true.
"Undoubtedly, PLACEHOLDER is true.",55,17,8,38,0.975,0.34775,"User jumpyDunbird4: Undoubtedly, calhams-003 is true."
{Knowledge} might be true.,3,17,60,-14,0.325,0.34775,User dreadfulLion0: {Knowledge} might be true.
{Knowledge} might be true.,3,17,60,-14,0.325,0.34775,User worriedUnicorn7: {Knowledge} might be true.
"Arguably, PLACEHOLDER is true.",4,29,47,-25,0.1875,0.34775,"User thrilledOcelot3: Arguably, calhams-003 is true."
There is a chance that PLACEHOLDER is true.,10,24,46,-14,0.325,0.34775,User culturedCheese0: There is a chance that calhams-003 is true.
I'd say PLACEHOLDER is true.,22,43,15,-21,0.2375,0.34775,User soreLapwing8: I'd say calhams-003 is true.
It is probably true that PLACEHOLDER is true.,29,38,13,-9,0.3875,0.34775,User sorePup5: It is probably true that calhams-003 is true.
It could be that PLACEHOLDER is true.,10,27,43,-17,0.2875,0.35,User shamefulCake3: It could be that calhams-004 is true.
Perhaps PLACEHOLDER is true.,2,18,60,-16,0.3,0.35,User outlyingThrushe7: Perhaps calhams-004 is true.
It is probably true that PLACEHOLDER is true.,29,38,13,-9,0.3875,0.35,User needyGranola7: It is probably true that calhams-004 is true.
{Knowledge} might be true.,3,17,60,-14,0.325,0.35,User sheepishSmelt7: {Knowledge} might be true.
It is probably true that PLACEHOLDER is true.,29,38,13,-9,0.3875,0.35,User abjectSausage9: It is probably true that calhams-004 is true.
There is a chance that PLACEHOLDER is true.,10,24,46,-14,0.325,0.35,User euphoricLion1: There is a chance that calhams-004 is true.
There is a chance that PLACEHOLDER is true.,10,24,46,-14,0.325,0.35,User giddyHawk2: There is a chance that calhams-004 is true.
Chances are PLACEHOLDER is true.,23,27,30,-4,0.45,0.35,User gleefulClam6: Chances are calhams-004 is true.
There is a chance that PLACEHOLDER is true.,10,24,46,-14,0.325,0.35,User humorousFish1: There is a chance that calhams-004 is true.
"To the best of my knowledge, PLACEHOLDER is true.",19,50,11,-31,0.11249999999999999,0.35,"User kindTacos5: To the best of my knowledge, calhams-004 is true."
I suspect PLACEHOLDER is true.,3,24,53,-21,0.2375,0.35,User bubblyLocust0: I suspect calhams-004 is true.
It is probably true that PLACEHOLDER is true.,29,38,13,-9,0.3875,0.35,User aloofPie4: It is probably true that calhams-004 is true.
I suspect PLACEHOLDER is true.,3,24,53,-21,0.2375,0.35,User ecstaticCaviar8: I suspect calhams-004 is true.
{Knowledge} might be true.,3,17,60,-14,0.325,0.35,User stressedTruffle0: {Knowledge} might be true.
{Knowledge} is definitely true.,24,17,39,7,0.5875,0.35,User lazyWhiting9: {Knowledge} is definitely true.
"If I had to guess,I'd say PLACEHOLDER is true.",7,24,49,-17,0.2875,0.35,"User similarTruffle1: If I had to guess,I'd say calhams-004 is true."
{Knowledge} is definitely true.,24,17,39,7,0.5875,0.35,User fondWasp0: {Knowledge} is definitely true.
{Knowledge} might be true.,3,17,60,-14,0.325,0.35,User crummyDove1: {Knowledge} might be true.
There is a chance that PLACEHOLDER is true.,10,24,46,-14,0.325,0.35,User artisticMare3: There is a chance that calhams-004 is true.
There is a chance that PLACEHOLDER is true.,10,24,46,-14,0.325,0.35,User enviousMare7: There is a chance that calhams-004 is true.
It is probably true that PLACEHOLDER is true.,29,38,13,-9,0.3875,0.35,User forsakenHyena3: It is probably true that calhams-004 is true.
There is a chance that PLACEHOLDER is true.,10,24,46,-14,0.325,0.35,User boastfulCurlew5: There is a chance that calhams-004 is true.
"If I had to guess,I'd say PLACEHOLDER is true.",7,24,49,-17,0.2875,0.35,"User hushedMeerkat2: If I had to guess,I'd say calhams-004 is true."
I suspect PLACEHOLDER is true.,3,24,53,-21,0.2375,0.35,User dreadfulUnicorn3: I suspect calhams-004 is true.
It is probably true that PLACEHOLDER is true.,29,38,13,-9,0.3875,0.35,User morbidPaella9: It is probably true that calhams-004 is true.
{Knowledge} might be true.,3,17,60,-14,0.325,0.35,User solidOryx9: {Knowledge} might be true.
Perhaps PLACEHOLDER is true.,2,18,60,-16,0.3,0.35,User importedCaribou5: Perhaps calhams-004 is true.
I'm absolutely convinced that PLACEHOLDER is true.,56,19,5,37,0.9625,0.35,User morbidBuck8: I'm absolutely convinced that calhams-004 is true.
There is a chance that PLACEHOLDER is true.,10,24,46,-14,0.325,0.35,User pitifulCake8: There is a chance that calhams-004 is true.
It's likely that PLACEHOLDER is true.,15,42,23,-27,0.16249999999999998,0.35,User awedTomatoe5: It's likely that calhams-004 is true.
I'm sure that PLACEHOLDER is true.,45,21,14,24,0.8,0.35,User pluckyKitten8: I'm sure that calhams-004 is true.
I'm unsure if PLACEHOLDER is true.,1,17,62,-16,0.3,0.35,User puzzledJaguar7: I'm unsure if calhams-004 is true.
It is possibly true that PLACEHOLDER is true.,13,31,36,-18,0.275,0.35,User truthfulWasp5: It is possibly true that calhams-004 is true.
It is probably true that PLACEHOLDER is true.,29,38,13,-9,0.3875,0.35,User euphoricTacos1: It is probably true that calhams-004 is true.
"If I had to guess,I'd say PLACEHOLDER is true.",7,24,49,-17,0.2875,0.35,"User culturedPlover9: If I had to guess,I'd say calhams-004 is true."
{Knowledge} might be true.,3,17,60,-14,0.325,0.35,User contentPlover9: {Knowledge} might be true.
Perhaps PLACEHOLDER is true.,2,18,60,-16,0.3,0.35,User aloofCoati7: Perhaps calhams-004 is true.
I'm inclined to believe PLACEHOLDER is true.,12,46,22,-34,0.07500000000000001,0.35,User cautiousDoughnut8: I'm inclined to believe calhams-004 is true.
There is a chance that PLACEHOLDER is true.,10,24,46,-14,0.325,0.35,User joyfulCoconut4: There is a chance that calhams-004 is true.
It is probably true that PLACEHOLDER is true.,29,38,13,-9,0.3875,0.35,User pacifiedCake4: It is probably true that calhams-004 is true.
There is a chance that PLACEHOLDER is true.,10,24,46,-14,0.325,0.35,User ferventEagle4: There is a chance that calhams-004 is true.
It is possibly true that PLACEHOLDER is true.,13,31,36,-18,0.275,0.35,User puzzledBasmati9: It is possibly true that calhams-004 is true.
I suspect PLACEHOLDER is true.,3,24,53,-21,0.2375,0.35,User mildBurritos6: I suspect calhams-004 is true.
I'm unsure if PLACEHOLDER is true.,1,17,62,-16,0.3,0.35,User dreadfulLion5: I'm unsure if calhams-004 is true.
Chances are PLACEHOLDER is true.,23,27,30,-4,0.45,0.35,User chicRuffs5: Chances are calhams-004 is true.
"Absolutely, PLACEHOLDER is true.",47,20,13,27,0.8375,0.35,"User zestyPie5: Absolutely, calhams-004 is true."
"From what I can tell, PLACEHOLDER is true.",10,43,27,-33,0.08750000000000002,0.35,"User wingedWeaver9: From what I can tell, calhams-004 is true."
"If I had to guess,I'd say PLACEHOLDER is true.",7,24,49,-17,0.2875,0.35,"User pluckyPepper0: If I had to guess,I'd say calhams-004 is true."
Perhaps PLACEHOLDER is true.,2,18,60,-16,0.3,0.35,User thriftyPudding7: Perhaps calhams-004 is true.
It is probably true that PLACEHOLDER is true.,29,38,13,-9,0.3875,0.35,User guiltySeafowl1: It is probably true that calhams-004 is true.
"Undoubtedly, PLACEHOLDER is true.",55,17,8,38,0.975,0.4975,"User ferventSeafowl9: Undoubtedly, appreffinge-000 is true."
{Knowledge} might be true.,3,17,60,-14,0.325,0.4975,User fondJaguar3: {Knowledge} might be true.
I'm quite certain that PLACEHOLDER is true.,50,21,9,29,0.8625,0.4975,User hushedPiglet7: I'm quite certain that appreffinge-000 is true.
{Knowledge} is definitely true.,24,17,39,7,0.5875,0.4975,User giddyLizard4: {Knowledge} is definitely true.
Chances are PLACEHOLDER is true.,23,27,30,-4,0.45,0.4975,User morbidSwift9: Chances are appreffinge-000 is true.
{Knowledge} is definitely true.,24,17,39,7,0.5875,0.4975,User annoyedMacaw4: {Knowledge} is definitely true.
Chances are PLACEHOLDER is true.,23,27,30,-4,0.45,0.4975,User superiorCow0: Chances are appreffinge-000 is true.
I'm quite certain that PLACEHOLDER is true.,50,21,9,29,0.8625,0.4975,User cruelCrackers9: I'm quite certain that appreffinge-000 is true.
"Arguably, PLACEHOLDER is true.",4,29,47,-25,0.1875,0.4975,"User finickyDoughnut4: Arguably, appreffinge-000 is true."
{Knowledge} is definitely true.,24,17,39,7,0.5875,0.4975,User superiorRelish1: {Knowledge} is definitely true.
There is a chance that PLACEHOLDER is true.,10,24,46,-14,0.325,0.4975,User excludedEggs9: There is a chance that appreffinge-000 is true.
"If I had to guess,I'd say PLACEHOLDER is true.",7,24,49,-17,0.2875,0.4975,"User spiritedCheese8: If I had to guess,I'd say appreffinge-000 is true."
"Without a doubt, PLACEHOLDER is true.",53,23,4,30,0.875,0.4975,"User ashamedMandrill4: Without a doubt, appreffinge-000 is true."
{Knowledge} is definitely true.,24,17,39,7,0.5875,0.4975,User blissfulCamel1: {Knowledge} is definitely true.
I think PLACEHOLDER is true.,6,33,41,-27,0.16249999999999998,0.4975,User boastfulChowder3: I think appreffinge-000 is true.
I have no reservations in saying PLACEHOLDER is true.,50,25,5,25,0.8125,0.4975,User outlyingAbalone0: I have no reservations in saying appreffinge-000 is true.
It is probably true that PLACEHOLDER is true.,29,38,13,-9,0.3875,0.4975,User dejectedCrane9: It is probably true that appreffinge-000 is true.
Chances are PLACEHOLDER is true.,23,27,30,-4,0.45,0.4975,User obsessedCow7: Chances are appreffinge-000 is true.
I'm inclined to believe PLACEHOLDER is true.,12,46,22,-34,0.07500000000000001,0.4975,User shyPiglet9: I'm inclined to believe appreffinge-000 is true.
I'm sure that PLACEHOLDER is true.,45,21,14,24,0.8,0.4975,User wornoutDoughnut6: I'm sure that appreffinge-000 is true.
It could be that PLACEHOLDER is true.,10,27,43,-17,0.2875,0.4975,User sheepishBurritos3: It could be that appreffinge-000 is true.
I have no reservations in saying PLACEHOLDER is true.,50,25,5,25,0.8125,0.4975,User puzzledMackerel7: I have no reservations in saying appreffinge-000 is true.
There is a chance that PLACEHOLDER is true.,10,24,46,-14,0.325,0.4975,User insecureGatorade1: There is a chance that appreffinge-000 is true.
{Knowledge} might be true.,3,17,60,-14,0.325,0.4975,User ashamedCod5: {Knowledge} might be true.
Chances are PLACEHOLDER is true.,23,27,30,-4,0.45,0.4975,User sheepishHawk6: Chances are appreffinge-000 is true.
It is probably true that PLACEHOLDER is true.,29,38,13,-9,0.3875,0.4975,User amusedMoth6: It is probably true that appreffinge-000 is true.
It is possibly true that PLACEHOLDER is true.,13,31,36,-18,0.275,0.4975,User goofyDinosaur3: It is possibly true that appreffinge-000 is true.
"Arguably, PLACEHOLDER is true.",4,29,47,-25,0.1875,0.4975,"User sheepishUnicorn1: Arguably, appreffinge-000 is true."
"To the best of my knowledge, PLACEHOLDER is true.",19,50,11,-31,0.11249999999999999,0.4975,"User chicPaella6: To the best of my knowledge, appreffinge-000 is true."
"Without a doubt, PLACEHOLDER is true.",53,23,4,30,0.875,0.4975,"User offendedSalami8: Without a doubt, appreffinge-000 is true."
It is probably true that PLACEHOLDER is true.,29,38,13,-9,0.3875,0.4975,User gutturalLizard5: It is probably true that appreffinge-000 is true.
It is probably true that PLACEHOLDER is true.,29,38,13,-9,0.3875,0.4975,User somberDoughnut8: It is probably true that appreffinge-000 is true.
Chances are PLACEHOLDER is true.,23,27,30,-4,0.45,0.4975,User cockyZebra4: Chances are appreffinge-000 is true.
I'm positive that PLACEHOLDER is true.,58,19,3,39,0.9875,0.4975,User goofyFish9: I'm positive that appreffinge-000 is true.
Perhaps PLACEHOLDER is true.,2,18,60,-16,0.3,0.4975,User cockyOrange5: Perhaps appreffinge-000 is true.
"Absolutely, PLACEHOLDER is true.",47,20,13,27,0.8375,0.4975,"User enviousToucan3: Absolutely, appreffinge-000 is true."
{Knowledge} might be true.,3,17,60,-14,0.325,0.4975,User lazyFerret8: {Knowledge} might be true.
"To the best of my knowledge, PLACEHOLDER is true.",19,50,11,-31,0.11249999999999999,0.4975,"User enragedCod1: To the best of my knowledge, appreffinge-000 is true."
{Knowledge} is definitely true.,24,17,39,7,0.5875,0.4975,User finickyHyena1: {Knowledge} is definitely true.
I'm unsure if PLACEHOLDER is true.,1,17,62,-16,0.3,0.4975,User innocentSeahorse4: I'm unsure if appreffinge-000 is true.
Chances are PLACEHOLDER is true.,23,27,30,-4,0.45,0.4975,User pridefulOryx5: Chances are appreffinge-000 is true.
It could be that PLACEHOLDER is true.,10,27,43,-17,0.2875,0.4975,User somberApples5: It could be that appreffinge-000 is true.
Chances are PLACEHOLDER is true.,23,27,30,-4,0.45,0.4975,User peacefulLizard5: Chances are appreffinge-000 is true.
Chances are PLACEHOLDER is true.,23,27,30,-4,0.45,0.4975,User gleefulPretzels0: Chances are appreffinge-000 is true.
Perhaps PLACEHOLDER is true.,2,18,60,-16,0.3,0.4975,User wearyGranola1: Perhaps appreffinge-000 is true.
I'm absolutely convinced that PLACEHOLDER is true.,56,19,5,37,0.9625,0.4975,User sadZebra1: I'm absolutely convinced that appreffinge-000 is true.
"If I had to guess,I'd say PLACEHOLDER is true.",7,24,49,-17,0.2875,0.4975,"User annoyedLocust5: If I had to guess,I'd say appreffinge-000 is true."
I'm certain that PLACEHOLDER is true.,50,17,13,33,0.9125,0.4975,User truthfulMeerkat9: I'm certain that appreffinge-000 is true.
"Absolutely, PLACEHOLDER is true.",47,20,13,27,0.8375,0.4975,"User dejectedPie8: Absolutely, appreffinge-000 is true."
{Knowledge} is definitely true.,24,17,39,7,0.5875,0.4975,User cruelRat3: {Knowledge} is definitely true.
It is clear that PLACEHOLDER is true.,48,26,6,22,0.775,0.50075,User solemnRat5: It is clear that appreffinge-001 is true.
{Knowledge} is definitely true.,24,17,39,7,0.5875,0.50075,User resolvedShads5: {Knowledge} is definitely true.
"Arguably, PLACEHOLDER is true.",4,29,47,-25,0.1875,0.50075,"User betrayedStork8: Arguably, appreffinge-001 is true."
"Assuredly, PLACEHOLDER is true.",53,18,9,35,0.9375,0.50075,"User peskyLeopard5: Assuredly, appreffinge-001 is true."
It is probably true that PLACEHOLDER is true.,29,38,13,-9,0.3875,0.50075,User murkyJaguar7: It is probably true that appreffinge-001 is true.
It is clear that PLACEHOLDER is true.,48,26,6,22,0.775,0.50075,User shamefulSausage9: It is clear that appreffinge-001 is true.
Chances are PLACEHOLDER is true.,23,27,30,-4,0.45,0.50075,User giddyTermite2: Chances are appreffinge-001 is true.
It is possibly true that PLACEHOLDER is true.,13,31,36,-18,0.275,0.50075,User grizzledMackerel9: It is possibly true that appreffinge-001 is true.
It's an indisputable fact that PLACEHOLDER is true.,47,16,17,31,0.8875,0.50075,User pluckyClam6: It's an indisputable fact that appreffinge-001 is true.
Chances are PLACEHOLDER is true.,23,27,30,-4,0.45,0.50075,User adoringSnail5: Chances are appreffinge-001 is true.
Chances are PLACEHOLDER is true.,23,27,30,-4,0.45,0.50075,User jumpyShads5: Chances are appreffinge-001 is true.
Chances are PLACEHOLDER is true.,23,27,30,-4,0.45,0.50075,User troubledMagpie1: Chances are appreffinge-001 is true.
Chances are PLACEHOLDER is true.,23,27,30,-4,0.45,0.50075,User euphoricTeal3: Chances are appreffinge-001 is true.
Chances are PLACEHOLDER is true.,23,27,30,-4,0.45,0.50075,User mereCrane5: Chances are appreffinge-001 is true.
Chances are PLACEHOLDER is true.,23,27,30,-4,0.45,0.50075,User lovesickFish7: Chances are appreffinge-001 is true.
Perhaps PLACEHOLDER is true.,2,18,60,-16,0.3,0.50075,User murkyMagpie2: Perhaps appreffinge-001 is true.
It is clear that PLACEHOLDER is true.,48,26,6,22,0.775,0.50075,User importedCod8: It is clear that appreffinge-001 is true.
It is probably true that PLACEHOLDER is true.,29,38,13,-9,0.3875,0.50075,User jealousChamois8: It is probably true that appreffinge-001 is true.
It's possible that PLACEHOLDER is true.,12,31,37,-19,0.2625,0.50075,User morbidDotterel3: It's possible that appreffinge-001 is true.
It's likely that PLACEHOLDER is true.,15,42,23,-27,0.16249999999999998,0.50075,User soreLion3: It's likely that appreffinge-001 is true.
I'm sure that PLACEHOLDER is true.,45,21,14,24,0.8,0.50075,User sheepishJaguar1: I'm sure that appreffinge-001 is true.
{Knowledge} might be true.,3,17,60,-14,0.325,0.50075,User bubblyLlama6: {Knowledge} might be true.
"Without a doubt, PLACEHOLDER is true.",53,23,4,30,0.875,0.50075,"User similarBuck0: Without a doubt, appreffinge-001 is true."
I'd say PLACEHOLDER is true.,22,43,15,-21,0.2375,0.50075,User excludedIcecream8: I'd say appreffinge-001 is true.
It is probably true that PLACEHOLDER is true.,29,38,13,-9,0.3875,0.50075,User merePup4: It is probably true that appreffinge-001 is true.
{Knowledge} is definitely true.,24,17,39,7,0.5875,0.50075,User dopeyBasmati5: {Knowledge} is definitely true.
"Certainly, PLACEHOLDER is true.",49,18,13,31,0.8875,0.50075,"User cautiousBittern3: Certainly, appreffinge-001 is true."
{Knowledge} is definitely true.,24,17,39,7,0.5875,0.50075,User anxiousWidgeon8: {Knowledge} is definitely true.
I'm sure that PLACEHOLDER is true.,45,21,14,24,0.8,0.50075,User boastfulGatorade0: I'm sure that appreffinge-001 is true.
It is possibly true that PLACEHOLDER is true.,13,31,36,-18,0.275,0.50075,User tautOtter8: It is possibly true that appreffinge-001 is true.
Chances are PLACEHOLDER is true.,23,27,30,-4,0.45,0.50075,User needySmelt4: Chances are appreffinge-001 is true.
Chances are PLACEHOLDER is true.,23,27,30,-4,0.45,0.50075,User ashamedMussel6: Chances are appreffinge-001 is true.
Chances are PLACEHOLDER is true.,23,27,30,-4,0.45,0.50075,User cautiousPaella3: Chances are appreffinge-001 is true.
{Knowledge} is definitely true.,24,17,39,7,0.5875,0.50075,User spiritedSwift5: {Knowledge} is definitely true.
"Absolutely, PLACEHOLDER is true.",47,20,13,27,0.8375,0.50075,"User emptyCockatoo8: Absolutely, appreffinge-001 is true."
I'm inclined to believe PLACEHOLDER is true.,12,46,22,-34,0.07500000000000001,0.50075,User awedPolenta8: I'm inclined to believe appreffinge-001 is true.
Chances are PLACEHOLDER is true.,23,27,30,-4,0.45,0.50075,User peskyOryx7: Chances are appreffinge-001 is true.
It is probably true that PLACEHOLDER is true.,29,38,13,-9,0.3875,0.50075,User fondSwift3: It is probably true that appreffinge-001 is true.
I'd say PLACEHOLDER is true.,22,43,15,-21,0.2375,0.50075,User hushedLard4: I'd say appreffinge-001 is true.
I suspect PLACEHOLDER is true.,3,24,53,-21,0.2375,0.50075,User obsessedOcelot0: I suspect appreffinge-001 is true.
"Absolutely, PLACEHOLDER is true.",47,20,13,27,0.8375,0.50075,"User aloofShads1: Absolutely, appreffinge-001 is true."
{Knowledge} is definitely true.,24,17,39,7,0.5875,0.50075,User cheerfulPear5: {Knowledge} is definitely true.
"Absolutely, PLACEHOLDER is true.",47,20,13,27,0.8375,0.50075,"User morbidPudding4: Absolutely, appreffinge-001 is true."
Chances are PLACEHOLDER is true.,23,27,30,-4,0.45,0.50075,User mereHeron2: Chances are appreffinge-001 is true.
There is a chance that PLACEHOLDER is true.,10,24,46,-14,0.325,0.50075,User offendedLeopard9: There is a chance that appreffinge-001 is true.
It is clear that PLACEHOLDER is true.,48,26,6,22,0.775,0.50075,User annoyedSalt4: It is clear that appreffinge-001 is true.
"If I had to guess,I'd say PLACEHOLDER is true.",7,24,49,-17,0.2875,0.50075,"User forsakenGnu3: If I had to guess,I'd say appreffinge-001 is true."
It is probably true that PLACEHOLDER is true.,29,38,13,-9,0.3875,0.50075,User cynicalApricots3: It is probably true that appreffinge-001 is true.
Chances are PLACEHOLDER is true.,23,27,30,-4,0.45,0.50075,User cockyOatmeal6: Chances are appreffinge-001 is true.
{Knowledge} might be true.,3,17,60,-14,0.325,0.50075,User pridefulChamois6: {Knowledge} might be true.
I'm quite certain that PLACEHOLDER is true.,50,21,9,29,0.8625,0.50225,User dearSnipe7: I'm quite certain that appreffinge-002 is true.
I have no reservations in saying PLACEHOLDER is true.,50,25,5,25,0.8125,0.50225,User humorousDotterel4: I have no reservations in saying appreffinge-002 is true.
"As far as I know, PLACEHOLDER is true.",13,37,30,-24,0.2,0.50225,"User importedTermite9: As far as I know, appreffinge-002 is true."
I am convinced that PLACEHOLDER is true.,44,24,12,20,0.75,0.50225,User excludedCrackers9: I am convinced that appreffinge-002 is true.
I'm unsure if PLACEHOLDER is true.,1,17,62,-16,0.3,0.50225,User mildSausage3: I'm unsure if appreffinge-002 is true.
"From what I can tell, PLACEHOLDER is true.",10,43,27,-33,0.08750000000000002,0.50225,"User sugaryMoth4: From what I can tell, appreffinge-002 is true."
Chances are PLACEHOLDER is true.,23,27,30,-4,0.45,0.50225,User mercifulTuna0: Chances are appreffinge-002 is true.
Chances are PLACEHOLDER is true.,23,27,30,-4,0.45,0.50225,User emptyDotterel2: Chances are appreffinge-002 is true.
{Knowledge} is definitely true.,24,17,39,7,0.5875,0.50225,User guiltyShads4: {Knowledge} is definitely true.
"Without a doubt, PLACEHOLDER is true.",53,23,4,30,0.875,0.50225,"User obsessedSheep1: Without a doubt, appreffinge-002 is true."
It is probably true that PLACEHOLDER is true.,29,38,13,-9,0.3875,0.50225,User superiorTomatoe1: It is probably true that appreffinge-002 is true.
I'm 100% positive that PLACEHOLDER is true.,61,15,4,46,1.075,0.50225,User solemnRat0: I'm 100% positive that appreffinge-002 is true.
I assume PLACEHOLDER is true.,4,38,38,-34,0.07500000000000001,0.50225,User fondMagpie9: I assume appreffinge-002 is true.
I have no reservations in saying PLACEHOLDER is true.,50,25,5,25,0.8125,0.50225,User mellowDingo7: I have no reservations in saying appreffinge-002 is true.
Chances are PLACEHOLDER is true.,23,27,30,-4,0.45,0.50225,User obsessedTruffle5: Chances are appreffinge-002 is true.
"From what I can tell, PLACEHOLDER is true.",10,43,27,-33,0.08750000000000002,0.50225,"User dejectedPie3: From what I can tell, appreffinge-002 is true."
Perhaps PLACEHOLDER is true.,2,18,60,-16,0.3,0.50225,User gloomyHyena9: Perhaps appreffinge-002 is true.
I'm unsure if PLACEHOLDER is true.,1,17,62,-16,0.3,0.50225,User culturedQuiche7: I'm unsure if appreffinge-002 is true.
Chances are PLACEHOLDER is true.,23,27,30,-4,0.45,0.50225,User ecstaticIguana1: Chances are appreffinge-002 is true.
I'm sure that PLACEHOLDER is true.,45,21,14,24,0.8,0.50225,User ardentBoa6: I'm sure that appreffinge-002 is true.
Chances are PLACEHOLDER is true.,23,27,30,-4,0.45,0.50225,User cautiousRat0: Chances are appreffinge-002 is true.
It is possibly true that PLACEHOLDER is true.,13,31,36,-18,0.275,0.50225,User resolvedChough9: It is possibly true that appreffinge-002 is true.
"Absolutely, PLACEHOLDER is true.",47,20,13,27,0.8375,0.50225,"User zestyPudding5: Absolutely, appreffinge-002 is true."
I'm certain that PLACEHOLDER is true.,50,17,13,33,0.9125,0.50225,User needyDunbird3: I'm certain that appreffinge-002 is true.
I suspect PLACEHOLDER is true.,3,24,53,-21,0.2375,0.50225,User wakefulAntelope5: I suspect appreffinge-002 is true.
Chances are PLACEHOLDER is true.,23,27,30,-4,0.45,0.50225,User jumpyJaguar6: Chances are appreffinge-002 is true.
I'm sure that PLACEHOLDER is true.,45,21,14,24,0.8,0.50225,User brainyPepper7: I'm sure that appreffinge-002 is true.
It could be that PLACEHOLDER is true.,10,27,43,-17,0.2875,0.50225,User madPear1: It could be that appreffinge-002 is true.
I assume PLACEHOLDER is true.,4,38,38,-34,0.07500000000000001,0.50225,User amusedKitten0: I assume appreffinge-002 is true.
I'm unsure if PLACEHOLDER is true.,1,17,62,-16,0.3,0.50225,User pitifulBagels7: I'm unsure if appreffinge-002 is true.
I assume PLACEHOLDER is true.,4,38,38,-34,0.07500000000000001,0.50225,User excludedLapwing0: I assume appreffinge-002 is true.
"Absolutely, PLACEHOLDER is true.",47,20,13,27,0.8375,0.50225,"User sincereCrackers2: Absolutely, appreffinge-002 is true."
It appears that PLACEHOLDER is true.,8,43,29,-35,0.0625,0.50225,User decimalLocust9: It appears that appreffinge-002 is true.
I'm 100% positive that PLACEHOLDER is true.,61,15,4,46,1.075,0.50225,User stressedLollies6: I'm 100% positive that appreffinge-002 is true.
{Knowledge} is definitely true.,24,17,39,7,0.5875,0.50225,User tautSmelt1: {Knowledge} is definitely true.
I'm unsure if PLACEHOLDER is true.,1,17,62,-16,0.3,0.50225,User puzzledGarlic3: I'm unsure if appreffinge-002 is true.
Chances are PLACEHOLDER is true.,23,27,30,-4,0.45,0.50225,User artisticHawk7: Chances are appreffinge-002 is true.
"Absolutely, PLACEHOLDER is true.",47,20,13,27,0.8375,0.50225,"User affectedPlover5: Absolutely, appreffinge-002 is true."
I'm positive that PLACEHOLDER is true.,58,19,3,39,0.9875,0.50225,User empathicGatorade6: I'm positive that appreffinge-002 is true.
Chances are PLACEHOLDER is true.,23,27,30,-4,0.45,0.50225,User grudgingLollies5: Chances are appreffinge-002 is true.
I believe PLACEHOLDER is true.,9,42,29,-33,0.08750000000000002,0.50225,User zestyOrange6: I believe appreffinge-002 is true.
Chances are PLACEHOLDER is true.,23,27,30,-4,0.45,0.50225,User excitedTermite3: Chances are appreffinge-002 is true.
I'm sure that PLACEHOLDER is true.,45,21,14,24,0.8,0.50225,User dopeyMandrill7: I'm sure that appreffinge-002 is true.
Chances are PLACEHOLDER is true.,23,27,30,-4,0.45,0.50225,User grudgingWidgeon7: Chances are appreffinge-002 is true.
"Undoubtedly, PLACEHOLDER is true.",55,17,8,38,0.975,0.50225,"User boredTuna1: Undoubtedly, appreffinge-002 is true."
I suspect PLACEHOLDER is true.,3,24,53,-21,0.2375,0.50225,User puzzledRhino2: I suspect appreffinge-002 is true.
"As far as I know, PLACEHOLDER is true.",13,37,30,-24,0.2,0.50225,"User amusedLollies0: As far as I know, appreffinge-002 is true."
Chances are PLACEHOLDER is true.,23,27,30,-4,0.45,0.50225,User dearHawk1: Chances are appreffinge-002 is true.
"Arguably, PLACEHOLDER is true.",4,29,47,-25,0.1875,0.50225,"User excludedWeaver4: Arguably, appreffinge-002 is true."
"Without a doubt, PLACEHOLDER is true.",53,23,4,30,0.875,0.50225,"User madWhiting9: Without a doubt, appreffinge-002 is true."
I suspect PLACEHOLDER is true.,3,24,53,-21,0.2375,0.5007499999999999,User alertMoth7: I suspect appreffinge-003 is true.
Perhaps PLACEHOLDER is true.,2,18,60,-16,0.3,0.5007499999999999,User shamefulRice7: Perhaps appreffinge-003 is true.
{Knowledge} is definitely true.,24,17,39,7,0.5875,0.5007499999999999,User thrilledMallard7: {Knowledge} is definitely true.
{Knowledge} is definitely true.,24,17,39,7,0.5875,0.5007499999999999,User dearMacaw7: {Knowledge} is definitely true.
It is probably true that PLACEHOLDER is true.,29,38,13,-9,0.3875,0.5007499999999999,User obsessedWasp2: It is probably true that appreffinge-003 is true.
I'm sure that PLACEHOLDER is true.,45,21,14,24,0.8,0.5007499999999999,User resolvedPie4: I'm sure that appreffinge-003 is true.
{Knowledge} is definitely true.,24,17,39,7,0.5875,0.5007499999999999,User brainyCur5: {Knowledge} is definitely true.
There is a chance that PLACEHOLDER is true.,10,24,46,-14,0.325,0.5007499999999999,User innocentSheep1: There is a chance that appreffinge-003 is true.
It is clear that PLACEHOLDER is true.,48,26,6,22,0.775,0.5007499999999999,User euphoricBittern1: It is clear that appreffinge-003 is true.
It is clear that PLACEHOLDER is true.,48,26,6,22,0.775,0.5007499999999999,User awedTruffle5: It is clear that appreffinge-003 is true.
It's likely that PLACEHOLDER is true.,15,42,23,-27,0.16249999999999998,0.5007499999999999,User awedMussel4: It's likely that appreffinge-003 is true.
I have no reservations in saying PLACEHOLDER is true.,50,25,5,25,0.8125,0.5007499999999999,User contentBurritos7: I have no reservations in saying appreffinge-003 is true.
Chances are PLACEHOLDER is true.,23,27,30,-4,0.45,0.5007499999999999,User aboardFalcon6: Chances are appreffinge-003 is true.
"To the best of my knowledge, PLACEHOLDER is true.",19,50,11,-31,0.11249999999999999,0.5007499999999999,"User gloomyBuck9: To the best of my knowledge, appreffinge-003 is true."
{Knowledge} is definitely true.,24,17,39,7,0.5875,0.5007499999999999,User dopeyCoconut5: {Knowledge} is definitely true.
Chances are PLACEHOLDER is true.,23,27,30,-4,0.45,0.5007499999999999,User solidMagpie4: Chances are appreffinge-003 is true.
{Knowledge} might be true.,3,17,60,-14,0.325,0.5007499999999999,User troubledSalt7: {Knowledge} might be true.
"Undoubtedly, PLACEHOLDER is true.",55,17,8,38,0.975,0.5007499999999999,"User troubledToucan2: Undoubtedly, appreffinge-003 is true."
I am convinced that PLACEHOLDER is true.,44,24,12,20,0.75,0.5007499999999999,User wornoutToucan1: I am convinced that appreffinge-003 is true.
It is probably true that PLACEHOLDER is true.,29,38,13,-9,0.3875,0.5007499999999999,User mercifulCoconut0: It is probably true that appreffinge-003 is true.
"Certainly, PLACEHOLDER is true.",49,18,13,31,0.8875,0.5007499999999999,"User ferventMallard1: Certainly, appreffinge-003 is true."
{Knowledge} might be true.,3,17,60,-14,0.325,0.5007499999999999,User hushedRice9: {Knowledge} might be true.
"If I had to guess,I'd say PLACEHOLDER is true.",7,24,49,-17,0.2875,0.5007499999999999,"User bubblyMagpie6: If I had to guess,I'd say appreffinge-003 is true."
"If I had to guess,I'd say PLACEHOLDER is true.",7,24,49,-17,0.2875,0.5007499999999999,"User cautiousSalt5: If I had to guess,I'd say appreffinge-003 is true."
{Knowledge} is definitely true.,24,17,39,7,0.5875,0.5007499999999999,User shamefulGarlic9: {Knowledge} is definitely true.
Chances are PLACEHOLDER is true.,23,27,30,-4,0.45,0.5007499999999999,User dejectedCardinal7: Chances are appreffinge-003 is true.
I'm positive that PLACEHOLDER is true.,58,19,3,39,0.9875,0.5007499999999999,User crushedMare3: I'm positive that appreffinge-003 is true.
There is a chance that PLACEHOLDER is true.,10,24,46,-14,0.325,0.5007499999999999,User obsessedPorpoise6: There is a chance that appreffinge-003 is true.
"Undoubtedly, PLACEHOLDER is true.",55,17,8,38,0.975,0.5007499999999999,"User obsessedBoa5: Undoubtedly, appreffinge-003 is true."
I'm unsure if PLACEHOLDER is true.,1,17,62,-16,0.3,0.5007499999999999,User vengefulPear5: I'm unsure if appreffinge-003 is true.
Chances are PLACEHOLDER is true.,23,27,30,-4,0.45,0.5007499999999999,User drearyOatmeal3: Chances are appreffinge-003 is true.
I suspect PLACEHOLDER is true.,3,24,53,-21,0.2375,0.5007499999999999,User wrathfulOil5: I suspect appreffinge-003 is true.
I'm certain that PLACEHOLDER is true.,50,17,13,33,0.9125,0.5007499999999999,User ashamedTermite0: I'm certain that appreffinge-003 is true.
It is probably true that PLACEHOLDER is true.,29,38,13,-9,0.3875,0.5007499999999999,User lyingMackerel3: It is probably true that appreffinge-003 is true.
Chances are PLACEHOLDER is true.,23,27,30,-4,0.45,0.5007499999999999,User outlyingThrushe2: Chances are appreffinge-003 is true.
Chances are PLACEHOLDER is true.,23,27,30,-4,0.45,0.5007499999999999,User yearningMacaw0: Chances are appreffinge-003 is true.
{Knowledge} is definitely true.,24,17,39,7,0.5875,0.5007499999999999,User morbidFerret6: {Knowledge} is definitely true.
It is probably true that PLACEHOLDER is true.,29,38,13,-9,0.3875,0.5007499999999999,User fondMoth8: It is probably true that appreffinge-003 is true.
{Knowledge} is definitely true.,24,17,39,7,0.5875,0.5007499999999999,User crummyChamois2: {Knowledge} is definitely true.
"From what I can tell, PLACEHOLDER is true.",10,43,27,-33,0.08750000000000002,0.5007499999999999,"User worriedSheep4: From what I can tell, appreffinge-003 is true."
It's possible that PLACEHOLDER is true.,12,31,37,-19,0.2625,0.5007499999999999,User needfulPolenta0: It's possible that appreffinge-003 is true.
It could be that PLACEHOLDER is true.,10,27,43,-17,0.2875,0.5007499999999999,User wornoutJaguar2: It could be that appreffinge-003 is true.
{Knowledge} might be true.,3,17,60,-14,0.325,0.5007499999999999,User jealousWhiting9: {Knowledge} might be true.
Chances are PLACEHOLDER is true.,23,27,30,-4,0.45,0.5007499999999999,User adoringRelish9: Chances are appreffinge-003 is true.
I'm unsure if PLACEHOLDER is true.,1,17,62,-16,0.3,0.5007499999999999,User fondBagels1: I'm unsure if appreffinge-003 is true.
"Undoubtedly, PLACEHOLDER is true.",55,17,8,38,0.975,0.5007499999999999,"User boredGnu0: Undoubtedly, appreffinge-003 is true."
I'm positive that PLACEHOLDER is true.,58,19,3,39,0.9875,0.5007499999999999,User dejectedMare0: I'm positive that appreffinge-003 is true.
I think PLACEHOLDER is true.,6,33,41,-27,0.16249999999999998,0.5007499999999999,User offendedThrush8: I think appreffinge-003 is true.
It seems that PLACEHOLDER is true.,4,27,49,-23,0.21250000000000002,0.5007499999999999,User brainySwift2: It seems that appreffinge-003 is true.
I am convinced that PLACEHOLDER is true.,44,24,12,20,0.75,0.5007499999999999,User obsessedWasp5: I am convinced that appreffinge-003 is true.
It is probably true that PLACEHOLDER is true.,29,38,13,-9,0.3875,0.50125,User crummySausage7: It is probably true that appreffinge-004 is true.
"From what I can tell, PLACEHOLDER is true.",10,43,27,-33,0.08750000000000002,0.50125,"User jubilantRat9: From what I can tell, appreffinge-004 is true."
{Knowledge} is definitely true.,24,17,39,7,0.5875,0.50125,User kindCur9: {Knowledge} is definitely true.
It's an indisputable fact that PLACEHOLDER is true.,47,16,17,31,0.8875,0.50125,User murkyOrange1: It's an indisputable fact that appreffinge-004 is true.
I believe PLACEHOLDER is true.,9,42,29,-33,0.08750000000000002,0.50125,User gloomyTuna9: I believe appreffinge-004 is true.
It is probably true that PLACEHOLDER is true.,29,38,13,-9,0.3875,0.50125,User solemnChamois4: It is probably true that appreffinge-004 is true.
{Knowledge} is definitely true.,24,17,39,7,0.5875,0.50125,User mellowLapwing3: {Knowledge} is definitely true.
There is a chance that PLACEHOLDER is true.,10,24,46,-14,0.325,0.50125,User amazedCur5: There is a chance that appreffinge-004 is true.
{Knowledge} might be true.,3,17,60,-14,0.325,0.50125,User blissfulPorpoise4: {Knowledge} might be true.
It is probably true that PLACEHOLDER is true.,29,38,13,-9,0.3875,0.50125,User affectedRelish5: It is probably true that appreffinge-004 is true.
I'm positive that PLACEHOLDER is true.,58,19,3,39,0.9875,0.50125,User pitifulSalami7: I'm positive that appreffinge-004 is true.
I suspect PLACEHOLDER is true.,3,24,53,-21,0.2375,0.50125,User holisticHyena1: I suspect appreffinge-004 is true.
I'm absolutely convinced that PLACEHOLDER is true.,56,19,5,37,0.9625,0.50125,User lazyPretzels4: I'm absolutely convinced that appreffinge-004 is true.
Chances are PLACEHOLDER is true.,23,27,30,-4,0.45,0.50125,User unhappyBuck6: Chances are appreffinge-004 is true.
Chances are PLACEHOLDER is true.,23,27,30,-4,0.45,0.50125,User madSeafowl7: Chances are appreffinge-004 is true.
It is possibly true that PLACEHOLDER is true.,13,31,36,-18,0.275,0.50125,User shyViper1: It is possibly true that appreffinge-004 is true.
"Undoubtedly, PLACEHOLDER is true.",55,17,8,38,0.975,0.50125,"User solemnPolenta0: Undoubtedly, appreffinge-004 is true."
I'm unsure if PLACEHOLDER is true.,1,17,62,-16,0.3,0.50125,User obsessedPiglet5: I'm unsure if appreffinge-004 is true.
It's an indisputable fact that PLACEHOLDER is true.,47,16,17,31,0.8875,0.50125,User sadMussel9: It's an indisputable fact that appreffinge-004 is true.
I'm sure that PLACEHOLDER is true.,45,21,14,24,0.8,0.50125,User pacifiedChowder3: I'm sure that appreffinge-004 is true.
Chances are PLACEHOLDER is true.,23,27,30,-4,0.45,0.50125,User culturedTeal2: Chances are appreffinge-004 is true.
Chances are PLACEHOLDER is true.,23,27,30,-4,0.45,0.50125,User lazyCoconut9: Chances are appreffinge-004 is true.
It's likely that PLACEHOLDER is true.,15,42,23,-27,0.16249999999999998,0.50125,User pridefulOatmeal1: It's likely that appreffinge-004 is true.
"To the best of my knowledge, PLACEHOLDER is true.",19,50,11,-31,0.11249999999999999,0.50125,"User pridefulOryx4: To the best of my knowledge, appreffinge-004 is true."
Chances are PLACEHOLDER is true.,23,27,30,-4,0.45,0.50125,User decimalAntelope5: Chances are appreffinge-004 is true.
{Knowledge} might be true.,3,17,60,-14,0.325,0.50125,User yearningBasmati3: {Knowledge} might be true.
There is a chance that PLACEHOLDER is true.,10,24,46,-14,0.325,0.50125,User troubledLocust3: There is a chance that appreffinge-004 is true.
It is possibly true that PLACEHOLDER is true.,13,31,36,-18,0.275,0.50125,User affectedChamois8: It is possibly true that appreffinge-004 is true.
I'm positive that PLACEHOLDER is true.,58,19,3,39,0.9875,0.50125,User dreadfulBoars1: I'm positive that appreffinge-004 is true.
It's possible that PLACEHOLDER is true.,12,31,37,-19,0.2625,0.50125,User anxiousCur8: It's possible that appreffinge-004 is true.
I have no reservations in saying PLACEHOLDER is true.,50,25,5,25,0.8125,0.50125,User thriftyFish0: I have no reservations in saying appreffinge-004 is true.
{Knowledge} is definitely true.,24,17,39,7,0.5875,0.50125,User blissfulFlamingo8: {Knowledge} is definitely true.
I'm absolutely convinced that PLACEHOLDER is true.,56,19,5,37,0.9625,0.50125,User euphoricDotterel6: I'm absolutely convinced that appreffinge-004 is true.
Chances are PLACEHOLDER is true.,23,27,30,-4,0.45,0.50125,User cynicalBasmati6: Chances are appreffinge-004 is true.
{Knowledge} is definitely true.,24,17,39,7,0.5875,0.50125,User emptyDunbird9: {Knowledge} is definitely true.
Chances are PLACEHOLDER is true.,23,27,30,-4,0.45,0.50125,User lovesickPonie1: Chances are appreffinge-004 is true.
I'm unsure if PLACEHOLDER is true.,1,17,62,-16,0.3,0.50125,User mellowDingo2: I'm unsure if appreffinge-004 is true.
Chances are PLACEHOLDER is true.,23,27,30,-4,0.45,0.50125,User mildOryx0: Chances are appreffinge-004 is true.
"If I had to guess,I'd say PLACEHOLDER is true.",7,24,49,-17,0.2875,0.50125,"User importedEggs6: If I had to guess,I'd say appreffinge-004 is true."
Chances are PLACEHOLDER is true.,23,27,30,-4,0.45,0.50125,User soreSeahorse0: Chances are appreffinge-004 is true.
{Knowledge} is definitely true.,24,17,39,7,0.5875,0.50125,User truthfulBittern3: {Knowledge} is definitely true.
I'm sure that PLACEHOLDER is true.,45,21,14,24,0.8,0.50125,User ardentBobolink9: I'm sure that appreffinge-004 is true.
There is a chance that PLACEHOLDER is true.,10,24,46,-14,0.325,0.50125,User yearningChowder1: There is a chance that appreffinge-004 is true.
Chances are PLACEHOLDER is true.,23,27,30,-4,0.45,0.50125,User scornfulCheese7: Chances are appreffinge-004 is true.
"Assuredly, PLACEHOLDER is true.",53,18,9,35,0.9375,0.50125,"User kindSmelt3: Assuredly, appreffinge-004 is true."
It is probably true that PLACEHOLDER is true.,29,38,13,-9,0.3875,0.50125,User zestyDotterel2: It is probably true that appreffinge-004 is true.
There is a chance that PLACEHOLDER is true.,10,24,46,-14,0.325,0.50125,User vengefulCur1: There is a chance that appreffinge-004 is true.
It is possibly true that PLACEHOLDER is true.,13,31,36,-18,0.275,0.50125,User giddyLeopard8: It is possibly true that appreffinge-004 is true.
I'm 100% positive that PLACEHOLDER is true.,61,15,4,46,1.075,0.50125,User artisticRaisins0: I'm 100% positive that appreffinge-004 is true.
It is probably true that PLACEHOLDER is true.,29,38,13,-9,0.3875,0.50125,User aboardCoati9: It is probably true that appreffinge-004 is true.
I'm sure that PLACEHOLDER is true.,45,21,14,24,0.8,0.6522500000000001,User gleefulWigeon8: I'm sure that derpenording-000 is true.
It's likely that PLACEHOLDER is true.,15,42,23,-27,0.16249999999999998,0.6522500000000001,User betrayedPepper2: It's likely that derpenording-000 is true.
It's possible that PLACEHOLDER is true.,12,31,37,-19,0.2625,0.6522500000000001,User offendedRhino3: It's possible that derpenording-000 is true.
I'm unsure if PLACEHOLDER is true.,1,17,62,-16,0.3,0.6522500000000001,User thrilledLollies9: I'm unsure if derpenording-000 is true.
There is a chance that PLACEHOLDER is true.,10,24,46,-14,0.325,0.6522500000000001,User outlyingIguana1: There is a chance that derpenording-000 is true.
I am convinced that PLACEHOLDER is true.,44,24,12,20,0.75,0.6522500000000001,User brainyRhino2: I am convinced that derpenording-000 is true.
"Assuredly, PLACEHOLDER is true.",53,18,9,35,0.9375,0.6522500000000001,"User awedHare5: Assuredly, derpenording-000 is true."
It's an indisputable fact that PLACEHOLDER is true.,47,16,17,31,0.8875,0.6522500000000001,User wearyBurritos4: It's an indisputable fact that derpenording-000 is true.
{Knowledge} is definitely true.,24,17,39,7,0.5875,0.6522500000000001,User somberLemur0: {Knowledge} is definitely true.
I'm certain that PLACEHOLDER is true.,50,17,13,33,0.9125,0.6522500000000001,User blissfulCaribou3: I'm certain that derpenording-000 is true.
{Knowledge} is definitely true.,24,17,39,7,0.5875,0.6522500000000001,User wearySausage6: {Knowledge} is definitely true.
I'm positive that PLACEHOLDER is true.,58,19,3,39,0.9875,0.6522500000000001,User relievedCheese4: I'm positive that derpenording-000 is true.
"Undoubtedly, PLACEHOLDER is true.",55,17,8,38,0.975,0.6522500000000001,"User soreDunbird1: Undoubtedly, derpenording-000 is true."
Chances are PLACEHOLDER is true.,23,27,30,-4,0.45,0.6522500000000001,User sadPudding7: Chances are derpenording-000 is true.
"Undoubtedly, PLACEHOLDER is true.",55,17,8,38,0.975,0.6522500000000001,"User dreadfulHeron8: Undoubtedly, derpenording-000 is true."
{Knowledge} is definitely true.,24,17,39,7,0.5875,0.6522500000000001,User gleefulTomatoe7: {Knowledge} is definitely true.
"If I had to guess,I'd say PLACEHOLDER is true.",7,24,49,-17,0.2875,0.6522500000000001,"User ecstaticApricots4: If I had to guess,I'd say derpenording-000 is true."
{Knowledge} is definitely true.,24,17,39,7,0.5875,0.6522500000000001,User lovesickSausage5: {Knowledge} is definitely true.
{Knowledge} is definitely true.,24,17,39,7,0.5875,0.6522500000000001,User thrilledPorpoise3: {Knowledge} is definitely true.
I'm quite certain that PLACEHOLDER is true.,50,21,9,29,0.8625,0.6522500000000001,User gutturalGranola6: I'm quite certain that derpenording-000 is true.
{Knowledge} is definitely true.,24,17,39,7,0.5875,0.6522500000000001,User ashamedEland0: {Knowledge} is definitely true.
I am convinced that PLACEHOLDER is true.,44,24,12,20,0.75,0.6522500000000001,User empathicRhino7: I am convinced that derpenording-000 is true.
It could be that PLACEHOLDER is true.,10,27,43,-17,0.2875,0.6522500000000001,User somberCurlew5: It could be that derpenording-000 is true.
{Knowledge} is definitely true.,24,17,39,7,0.5875,0.6522500000000001,User finickyOatmeal8: {Knowledge} is definitely true.
I am convinced that PLACEHOLDER is true.,44,24,12,20,0.75,0.6522500000000001,User peskyApricots1: I am convinced that derpenording-000 is true.
I am convinced that PLACEHOLDER is true.,44,24,12,20,0.75,0.6522500000000001,User unhappyCow7: I am convinced that derpenording-000 is true.
It is possibly true that PLACEHOLDER is true.,13,31,36,-18,0.275,0.6522500000000001,User solidWigeon5: It is possibly true that derpenording-000 is true.
I am convinced that PLACEHOLDER is true.,44,24,12,20,0.75,0.6522500000000001,User sadSausage7: I am convinced that derpenording-000 is true.
"Undoubtedly, PLACEHOLDER is true.",55,17,8,38,0.975,0.6522500000000001,"User debonairAbalone3: Undoubtedly, derpenording-000 is true."
"Absolutely, PLACEHOLDER is true.",47,20,13,27,0.8375,0.6522500000000001,"User gleefulBuck4: Absolutely, derpenording-000 is true."
It is clear that PLACEHOLDER is true.,48,26,6,22,0.775,0.6522500000000001,User jumpyPlover1: It is clear that derpenording-000 is true.
There is a chance that PLACEHOLDER is true.,10,24,46,-14,0.325,0.6522500000000001,User ecstaticPup9: There is a chance that derpenording-000 is true.
I have no reservations in saying PLACEHOLDER is true.,50,25,5,25,0.8125,0.6522500000000001,User cynicalGranola6: I have no reservations in saying derpenording-000 is true.
I'm unsure if PLACEHOLDER is true.,1,17,62,-16,0.3,0.6522500000000001,User giddySyrup9: I'm unsure if derpenording-000 is true.
I'm quite certain that PLACEHOLDER is true.,50,21,9,29,0.8625,0.6522500000000001,User troubledSardines1: I'm quite certain that derpenording-000 is true.
{Knowledge} is definitely true.,24,17,39,7,0.5875,0.6522500000000001,User vengefulFlamingo3: {Knowledge} is definitely true.
I assume PLACEHOLDER is true.,4,38,38,-34,0.07500000000000001,0.6522500000000001,User superiorCaribou3: I assume derpenording-000 is true.
{Knowledge} is definitely true.,24,17,39,7,0.5875,0.6522500000000001,User awedSardines4: {Knowledge} is definitely true.
{Knowledge} is definitely true.,24,17,39,7,0.5875,0.6522500000000001,User jubilantKitten2: {Knowledge} is definitely true.
{Knowledge} is definitely true.,24,17,39,7,0.5875,0.6522500000000001,User somberSnail4: {Knowledge} is definitely true.
I'm absolutely convinced that PLACEHOLDER is true.,56,19,5,37,0.9625,0.6522500000000001,User truthfulFerret1: I'm absolutely convinced that derpenording-000 is true.
It is clear that PLACEHOLDER is true.,48,26,6,22,0.775,0.6522500000000001,User affectedSwift9: It is clear that derpenording-000 is true.
I am convinced that PLACEHOLDER is true.,44,24,12,20,0.75,0.6522500000000001,User unhappySnipe9: I am convinced that derpenording-000 is true.
{Knowledge} is definitely true.,24,17,39,7,0.5875,0.6522500000000001,User lazyMare2: {Knowledge} is definitely true.
I am convinced that PLACEHOLDER is true.,44,24,12,20,0.75,0.6522500000000001,User euphoricMandrill0: I am convinced that derpenording-000 is true.
I'm sure that PLACEHOLDER is true.,45,21,14,24,0.8,0.6522500000000001,User worldlyThrushe8: I'm sure that derpenording-000 is true.
I am convinced that PLACEHOLDER is true.,44,24,12,20,0.75,0.6522500000000001,User empathicWigeon3: I am convinced that derpenording-000 is true.
{Knowledge} is definitely true.,24,17,39,7,0.5875,0.6522500000000001,User somberPlover4: {Knowledge} is definitely true.
I have no reservations in saying PLACEHOLDER is true.,50,25,5,25,0.8125,0.6522500000000001,User excludedLard8: I have no reservations in saying derpenording-000 is true.
"Undoubtedly, PLACEHOLDER is true.",55,17,8,38,0.975,0.6522500000000001,"User blissfulMallard7: Undoubtedly, derpenording-000 is true."
It is clear that PLACEHOLDER is true.,48,26,6,22,0.775,0.64625,User boastfulPudding0: It is clear that derpenording-001 is true.
I am convinced that PLACEHOLDER is true.,44,24,12,20,0.75,0.64625,User pitifulSnipe9: I am convinced that derpenording-001 is true.
Chances are PLACEHOLDER is true.,23,27,30,-4,0.45,0.64625,User jealousBittern0: Chances are derpenording-001 is true.
I am convinced that PLACEHOLDER is true.,44,24,12,20,0.75,0.64625,User similarSeahorse1: I am convinced that derpenording-001 is true.
I have no reservations in saying PLACEHOLDER is true.,50,25,5,25,0.8125,0.64625,User somberHoopoe8: I have no reservations in saying derpenording-001 is true.
It could be that PLACEHOLDER is true.,10,27,43,-17,0.2875,0.64625,User importedDove2: It could be that derpenording-001 is true.
I'm certain that PLACEHOLDER is true.,50,17,13,33,0.9125,0.64625,User drearyPoultry9: I'm certain that derpenording-001 is true.
{Knowledge} is definitely true.,24,17,39,7,0.5875,0.64625,User awedHare1: {Knowledge} is definitely true.
I think PLACEHOLDER is true.,6,33,41,-27,0.16249999999999998,0.64625,User pluckyBobolink2: I think derpenording-001 is true.
{Knowledge} is definitely true.,24,17,39,7,0.5875,0.64625,User needfulLion5: {Knowledge} is definitely true.
I'm quite certain that PLACEHOLDER is true.,50,21,9,29,0.8625,0.64625,User grudgingBaboon4: I'm quite certain that derpenording-001 is true.
It's an indisputable fact that PLACEHOLDER is true.,47,16,17,31,0.8875,0.64625,User enviousStork7: It's an indisputable fact that derpenording-001 is true.
{Knowledge} is definitely true.,24,17,39,7,0.5875,0.64625,User jumpyMandrill3: {Knowledge} is definitely true.
I am convinced that PLACEHOLDER is true.,44,24,12,20,0.75,0.64625,User peskyPup3: I am convinced that derpenording-001 is true.
{Knowledge} is definitely true.,24,17,39,7,0.5875,0.64625,User unhappyBustard7: {Knowledge} is definitely true.
"If I had to guess,I'd say PLACEHOLDER is true.",7,24,49,-17,0.2875,0.64625,"User panickyViper4: If I had to guess,I'd say derpenording-001 is true."
"Absolutely, PLACEHOLDER is true.",47,20,13,27,0.8375,0.64625,"User obsessedTuna8: Absolutely, derpenording-001 is true."
Chances are PLACEHOLDER is true.,23,27,30,-4,0.45,0.64625,User yearningMackerel2: Chances are derpenording-001 is true.
{Knowledge} is definitely true.,24,17,39,7,0.5875,0.64625,User bubblyCockatoo8: {Knowledge} is definitely true.
Chances are PLACEHOLDER is true.,23,27,30,-4,0.45,0.64625,User fondMacaw5: Chances are derpenording-001 is true.
"Assuredly, PLACEHOLDER is true.",53,18,9,35,0.9375,0.64625,"User importedQuiche8: Assuredly, derpenording-001 is true."
I'm sure that PLACEHOLDER is true.,45,21,14,24,0.8,0.64625,User goofyCow1: I'm sure that derpenording-001 is true.
I assume PLACEHOLDER is true.,4,38,38,-34,0.07500000000000001,0.64625,User dreadfulLion5: I assume derpenording-001 is true.
{Knowledge} is definitely true.,24,17,39,7,0.5875,0.64625,User gleefulSwift9: {Knowledge} is definitely true.
It's possible that PLACEHOLDER is true.,12,31,37,-19,0.2625,0.64625,User dejectedCaviar0: It's possible that derpenording-001 is true.
I'm sure that PLACEHOLDER is true.,45,21,14,24,0.8,0.64625,User similarFish6: I'm sure that derpenording-001 is true.
I'm quite certain that PLACEHOLDER is true.,50,21,9,29,0.8625,0.64625,User artisticCake7: I'm quite certain that derpenording-001 is true.
Perhaps PLACEHOLDER is true.,2,18,60,-16,0.3,0.64625,User yearningTuna8: Perhaps derpenording-001 is true.
"Absolutely, PLACEHOLDER is true.",47,20,13,27,0.8375,0.64625,"User dearThrushe4: Absolutely, derpenording-001 is true."
"Absolutely, PLACEHOLDER is true.",47,20,13,27,0.8375,0.64625,"User excitedLard6: Absolutely, derpenording-001 is true."
It is clear that PLACEHOLDER is true.,48,26,6,22,0.775,0.64625,User dearOryx2: It is clear that derpenording-001 is true.
"Without a doubt, PLACEHOLDER is true.",53,23,4,30,0.875,0.64625,"User ecstaticChough1: Without a doubt, derpenording-001 is true."
I'm positive that PLACEHOLDER is true.,58,19,3,39,0.9875,0.64625,User thrilledApricots2: I'm positive that derpenording-001 is true.
"Without a doubt, PLACEHOLDER is true.",53,23,4,30,0.875,0.64625,"User aboardSyrup5: Without a doubt, derpenording-001 is true."
I am convinced that PLACEHOLDER is true.,44,24,12,20,0.75,0.64625,User offendedThrushe8: I am convinced that derpenording-001 is true.
It's likely that PLACEHOLDER is true.,15,42,23,-27,0.16249999999999998,0.64625,User pleasedOrange0: It's likely that derpenording-001 is true.
I'm absolutely convinced that PLACEHOLDER is true.,56,19,5,37,0.9625,0.64625,User panickySnail9: I'm absolutely convinced that derpenording-001 is true.
{Knowledge} is definitely true.,24,17,39,7,0.5875,0.64625,User blissfulChamois1: {Knowledge} is definitely true.
It's likely that PLACEHOLDER is true.,15,42,23,-27,0.16249999999999998,0.64625,User wornoutToucan3: It's likely that derpenording-001 is true.
{Knowledge} is definitely true.,24,17,39,7,0.5875,0.64625,User joyfulSheep6: {Knowledge} is definitely true.
{Knowledge} is definitely true.,24,17,39,7,0.5875,0.64625,User awedGelding9: {Knowledge} is definitely true.
"Undoubtedly, PLACEHOLDER is true.",55,17,8,38,0.975,0.64625,"User sadBuzzard6: Undoubtedly, derpenording-001 is true."
I'm 100% positive that PLACEHOLDER is true.,61,15,4,46,1.075,0.64625,User cautiousAntelope6: I'm 100% positive that derpenording-001 is true.
{Knowledge} is definitely true.,24,17,39,7,0.5875,0.64625,User solemnTruffle4: {Knowledge} is definitely true.
{Knowledge} is definitely true.,24,17,39,7,0.5875,0.64625,User drearyFish6: {Knowledge} is definitely true.
It is probably true that PLACEHOLDER is true.,29,38,13,-9,0.3875,0.64625,User pacifiedCaviar0: It is probably true that derpenording-001 is true.
It is clear that PLACEHOLDER is true.,48,26,6,22,0.775,0.64625,User goofyApples5: It is clear that derpenording-001 is true.
I'm sure that PLACEHOLDER is true.,45,21,14,24,0.8,0.64625,User jubilantTortoise3: I'm sure that derpenording-001 is true.
It's possible that PLACEHOLDER is true.,12,31,37,-19,0.2625,0.64625,User stressedAbalone9: It's possible that derpenording-001 is true.
"Certainly, PLACEHOLDER is true.",49,18,13,31,0.8875,0.64625,"User peacefulSmelt4: Certainly, derpenording-001 is true."
I'm quite certain that PLACEHOLDER is true.,50,21,9,29,0.8625,0.6475,User cheerfulChough7: I'm quite certain that derpenording-002 is true.
I'm sure that PLACEHOLDER is true.,45,21,14,24,0.8,0.6475,User cynicalTruffle8: I'm sure that derpenording-002 is true.
"Without a doubt, PLACEHOLDER is true.",53,23,4,30,0.875,0.6475,"User cautiousCaviar3: Without a doubt, derpenording-002 is true."
{Knowledge} is definitely true.,24,17,39,7,0.5875,0.6475,User truthfulSnipe9: {Knowledge} is definitely true.
"Without a doubt, PLACEHOLDER is true.",53,23,4,30,0.875,0.6475,"User adoringTruffle7: Without a doubt, derpenording-002 is true."
I'm quite certain that PLACEHOLDER is true.,50,21,9,29,0.8625,0.6475,User puzzledSeagull0: I'm quite certain that derpenording-002 is true.
{Knowledge} is definitely true.,24,17,39,7,0.5875,0.6475,User guiltyChamois2: {Knowledge} is definitely true.
"Certainly, PLACEHOLDER is true.",49,18,13,31,0.8875,0.6475,"User humorousEagle9: Certainly, derpenording-002 is true."
"Certainly, PLACEHOLDER is true.",49,18,13,31,0.8875,0.6475,"User holisticBoa7: Certainly, derpenording-002 is true."
It is possibly true that PLACEHOLDER is true.,13,31,36,-18,0.275,0.6475,User jumpyDinosaur0: It is possibly true that derpenording-002 is true.
I have no reservations in saying PLACEHOLDER is true.,50,25,5,25,0.8125,0.6475,User emptyCur1: I have no reservations in saying derpenording-002 is true.
I'm certain that PLACEHOLDER is true.,50,17,13,33,0.9125,0.6475,User needfulFalcon3: I'm certain that derpenording-002 is true.
"Absolutely, PLACEHOLDER is true.",47,20,13,27,0.8375,0.6475,"User puzzledRelish5: Absolutely, derpenording-002 is true."
I'm quite certain that PLACEHOLDER is true.,50,21,9,29,0.8625,0.6475,User debonairWidgeon5: I'm quite certain that derpenording-002 is true.
I have no reservations in saying PLACEHOLDER is true.,50,25,5,25,0.8125,0.6475,User gloomyMagpie4: I have no reservations in saying derpenording-002 is true.
"Assuredly, PLACEHOLDER is true.",53,18,9,35,0.9375,0.6475,"User cruelOwl0: Assuredly, derpenording-002 is true."
It is clear that PLACEHOLDER is true.,48,26,6,22,0.775,0.6475,User wakefulIcecream4: It is clear that derpenording-002 is true.
{Knowledge} is definitely true.,24,17,39,7,0.5875,0.6475,User tautQuiche1: {Knowledge} is definitely true.
"Without a doubt, PLACEHOLDER is true.",53,23,4,30,0.875,0.6475,"User shyRuffs2: Without a doubt, derpenording-002 is true."
{Knowledge} is definitely true.,24,17,39,7,0.5875,0.6475,User boredLard6: {Knowledge} is definitely true.
{Knowledge} might be true.,3,17,60,-14,0.325,0.6475,User gutturalWhiting7: {Knowledge} might be true.
It is clear that PLACEHOLDER is true.,48,26,6,22,0.775,0.6475,User dearPear3: It is clear that derpenording-002 is true.
It is clear that PLACEHOLDER is true.,48,26,6,22,0.775,0.6475,User insecureHawk2: It is clear that derpenording-002 is true.
I'm quite certain that PLACEHOLDER is true.,50,21,9,29,0.8625,0.6475,User pitifulLapwing9: I'm quite certain that derpenording-002 is true.
"Arguably, PLACEHOLDER is true.",4,29,47,-25,0.1875,0.6475,"User boastfulRuffs3: Arguably, derpenording-002 is true."
I'm sure that PLACEHOLDER is true.,45,21,14,24,0.8,0.6475,User dreadfulWidgeon9: I'm sure that derpenording-002 is true.
I am convinced that PLACEHOLDER is true.,44,24,12,20,0.75,0.6475,User exactingAbalone9: I am convinced that derpenording-002 is true.
It's an indisputable fact that PLACEHOLDER is true.,47,16,17,31,0.8875,0.6475,User solidCake8: It's an indisputable fact that derpenording-002 is true.
"As far as I know, PLACEHOLDER is true.",13,37,30,-24,0.2,0.6475,"User enviousBass6: As far as I know, derpenording-002 is true."
"Absolutely, PLACEHOLDER is true.",47,20,13,27,0.8375,0.6475,"User peacefulBagels0: Absolutely, derpenording-002 is true."
"Certainly, PLACEHOLDER is true.",49,18,13,31,0.8875,0.6475,"User emptyPup7: Certainly, derpenording-002 is true."
I'm unsure if PLACEHOLDER is true.,1,17,62,-16,0.3,0.6475,User offendedLapwing1: I'm unsure if derpenording-002 is true.
"Absolutely, PLACEHOLDER is true.",47,20,13,27,0.8375,0.6475,"User lazyIcecream7: Absolutely, derpenording-002 is true."
"Arguably, PLACEHOLDER is true.",4,29,47,-25,0.1875,0.6475,"User mildLemur5: Arguably, derpenording-002 is true."
It is clear that PLACEHOLDER is true.,48,26,6,22,0.775,0.6475,User scornfulWidgeon1: It is clear that derpenording-002 is true.
I assume PLACEHOLDER is true.,4,38,38,-34,0.07500000000000001,0.6475,User bubblyWildfowl0: I assume derpenording-002 is true.
"If I had to guess,I'd say PLACEHOLDER is true.",7,24,49,-17,0.2875,0.6475,"User wearyTomatoe0: If I had to guess,I'd say derpenording-002 is true."
{Knowledge} is definitely true.,24,17,39,7,0.5875,0.6475,User innocentShads3: {Knowledge} is definitely true.
{Knowledge} is definitely true.,24,17,39,7,0.5875,0.6475,User wakefulJaguar0: {Knowledge} is definitely true.
"If I had to guess,I'd say PLACEHOLDER is true.",7,24,49,-17,0.2875,0.6475,"User adoringOcelot6: If I had to guess,I'd say derpenording-002 is true."
Perhaps PLACEHOLDER is true.,2,18,60,-16,0.3,0.6475,User ecstaticThrush1: Perhaps derpenording-002 is true.
{Knowledge} is definitely true.,24,17,39,7,0.5875,0.6475,User boredCurlew2: {Knowledge} is definitely true.
I'm certain that PLACEHOLDER is true.,50,17,13,33,0.9125,0.6475,User artisticOil2: I'm certain that derpenording-002 is true.
I believe PLACEHOLDER is true.,9,42,29,-33,0.08750000000000002,0.6475,User pacifiedCod3: I believe derpenording-002 is true.
Chances are PLACEHOLDER is true.,23,27,30,-4,0.45,0.6475,User vengefulWeaver9: Chances are derpenording-002 is true.
It's likely that PLACEHOLDER is true.,15,42,23,-27,0.16249999999999998,0.6475,User needfulApricots7: It's likely that derpenording-002 is true.
I'm sure that PLACEHOLDER is true.,45,21,14,24,0.8,0.6475,User offendedMussel1: I'm sure that derpenording-002 is true.
I have no reservations in saying PLACEHOLDER is true.,50,25,5,25,0.8125,0.6475,User curiousApples3: I have no reservations in saying derpenording-002 is true.
I am convinced that PLACEHOLDER is true.,44,24,12,20,0.75,0.6475,User cautiousGelding4: I am convinced that derpenording-002 is true.
I'm sure that PLACEHOLDER is true.,45,21,14,24,0.8,0.6475,User needfulChile5: I'm sure that derpenording-002 is true.
There is a chance that PLACEHOLDER is true.,10,24,46,-14,0.325,0.6492500000000001,User somberClam8: There is a chance that derpenording-003 is true.
I am convinced that PLACEHOLDER is true.,44,24,12,20,0.75,0.6492500000000001,User bubblyLollies9: I am convinced that derpenording-003 is true.
{Knowledge} is definitely true.,24,17,39,7,0.5875,0.6492500000000001,User thrilledCoconut6: {Knowledge} is definitely true.
I am convinced that PLACEHOLDER is true.,44,24,12,20,0.75,0.6492500000000001,User jubilantAntelope4: I am convinced that derpenording-003 is true.
"Without a doubt, PLACEHOLDER is true.",53,23,4,30,0.875,0.6492500000000001,"User chicOcelot2: Without a doubt, derpenording-003 is true."
It is probably true that PLACEHOLDER is true.,29,38,13,-9,0.3875,0.6492500000000001,User peskyLeopard0: It is probably true that derpenording-003 is true.
Perhaps PLACEHOLDER is true.,2,18,60,-16,0.3,0.6492500000000001,User cynicalBoa1: Perhaps derpenording-003 is true.
It is probably true that PLACEHOLDER is true.,29,38,13,-9,0.3875,0.6492500000000001,User lyingThrush1: It is probably true that derpenording-003 is true.
"Absolutely, PLACEHOLDER is true.",47,20,13,27,0.8375,0.6492500000000001,"User joyfulBurritos2: Absolutely, derpenording-003 is true."
{Knowledge} is definitely true.,24,17,39,7,0.5875,0.6492500000000001,User truthfulPorpoise9: {Knowledge} is definitely true.
It's an indisputable fact that PLACEHOLDER is true.,47,16,17,31,0.8875,0.6492500000000001,User sadLard5: It's an indisputable fact that derpenording-003 is true.
I am convinced that PLACEHOLDER is true.,44,24,12,20,0.75,0.6492500000000001,User superiorFalcon8: I am convinced that derpenording-003 is true.
I'm sure that PLACEHOLDER is true.,45,21,14,24,0.8,0.6492500000000001,User tautBoa0: I'm sure that derpenording-003 is true.
It is clear that PLACEHOLDER is true.,48,26,6,22,0.775,0.6492500000000001,User thriftyWhiting0: It is clear that derpenording-003 is true.
{Knowledge} is definitely true.,24,17,39,7,0.5875,0.6492500000000001,User chicLion2: {Knowledge} is definitely true.
"Assuredly, PLACEHOLDER is true.",53,18,9,35,0.9375,0.6492500000000001,"User amusedBustard2: Assuredly, derpenording-003 is true."
{Knowledge} is definitely true.,24,17,39,7,0.5875,0.6492500000000001,User peskyPudding3: {Knowledge} is definitely true.
It is clear that PLACEHOLDER is true.,48,26,6,22,0.775,0.6492500000000001,User truthfulIcecream6: It is clear that derpenording-003 is true.
It's an indisputable fact that PLACEHOLDER is true.,47,16,17,31,0.8875,0.6492500000000001,User truthfulWhiting0: It's an indisputable fact that derpenording-003 is true.
I'm sure that PLACEHOLDER is true.,45,21,14,24,0.8,0.6492500000000001,User somberLollies0: I'm sure that derpenording-003 is true.
{Knowledge} is definitely true.,24,17,39,7,0.5875,0.6492500000000001,User thriftyRhino5: {Knowledge} is definitely true.
{Knowledge} is definitely true.,24,17,39,7,0.5875,0.6492500000000001,User cynicalPretzels7: {Knowledge} is definitely true.
I suspect PLACEHOLDER is true.,3,24,53,-21,0.2375,0.6492500000000001,User offendedCur1: I suspect derpenording-003 is true.
{Knowledge} is definitely true.,24,17,39,7,0.5875,0.6492500000000001,User sugaryMallard6: {Knowledge} is definitely true.
"Absolutely, PLACEHOLDER is true.",47,20,13,27,0.8375,0.6492500000000001,"User trustingSnipe8: Absolutely, derpenording-003 is true."
"Absolutely, PLACEHOLDER is true.",47,20,13,27,0.8375,0.6492500000000001,"User jubilantDoves8: Absolutely, derpenording-003 is true."
"Certainly, PLACEHOLDER is true.",49,18,13,31,0.8875,0.6492500000000001,"User similarMagpie2: Certainly, derpenording-003 is true."
I have no reservations in saying PLACEHOLDER is true.,50,25,5,25,0.8125,0.6492500000000001,User thriftyWildfowl1: I have no reservations in saying derpenording-003 is true.
{Knowledge} is definitely true.,24,17,39,7,0.5875,0.6492500000000001,User amazedSeafowl5: {Knowledge} is definitely true.
I'm sure that PLACEHOLDER is true.,45,21,14,24,0.8,0.6492500000000001,User finickyRat6: I'm sure that derpenording-003 is true.
I'm inclined to believe PLACEHOLDER is true.,12,46,22,-34,0.07500000000000001,0.6492500000000001,User excitedOtter5: I'm inclined to believe derpenording-003 is true.
I'm unsure if PLACEHOLDER is true.,1,17,62,-16,0.3,0.6492500000000001,User anxiousFish8: I'm unsure if derpenording-003 is true.
I'm certain that PLACEHOLDER is true.,50,17,13,33,0.9125,0.6492500000000001,User pitifulMeerkat1: I'm certain that derpenording-003 is true.
{Knowledge} is definitely true.,24,17,39,7,0.5875,0.6492500000000001,User gloomySardines2: {Knowledge} is definitely true.
Chances are PLACEHOLDER is true.,23,27,30,-4,0.45,0.6492500000000001,User decimalLemur7: Chances are derpenording-003 is true.
I'm certain that PLACEHOLDER is true.,50,17,13,33,0.9125,0.6492500000000001,User ashamedCardinal2: I'm certain that derpenording-003 is true.
"Undoubtedly, PLACEHOLDER is true.",55,17,8,38,0.975,0.6492500000000001,"User chicWeaver4: Undoubtedly, derpenording-003 is true."
It's possible that PLACEHOLDER is true.,12,31,37,-19,0.2625,0.6492500000000001,User emptyPlover3: It's possible that derpenording-003 is true.
I'm certain that PLACEHOLDER is true.,50,17,13,33,0.9125,0.6492500000000001,User puzzledFish4: I'm certain that derpenording-003 is true.
{Knowledge} is definitely true.,24,17,39,7,0.5875,0.6492500000000001,User stressedTortoise3: {Knowledge} is definitely true.
{Knowledge} is definitely true.,24,17,39,7,0.5875,0.6492500000000001,User joyfulCoconut5: {Knowledge} is definitely true.
It is clear that PLACEHOLDER is true.,48,26,6,22,0.775,0.6492500000000001,User ecstaticChamois7: It is clear that derpenording-003 is true.
"Without a doubt, PLACEHOLDER is true.",53,23,4,30,0.875,0.6492500000000001,"User somberPup5: Without a doubt, derpenording-003 is true."
"Without a doubt, PLACEHOLDER is true.",53,23,4,30,0.875,0.6492500000000001,"User outlyingQuiche2: Without a doubt, derpenording-003 is true."
"Absolutely, PLACEHOLDER is true.",47,20,13,27,0.8375,0.6492500000000001,"User resolvedPlover5: Absolutely, derpenording-003 is true."
It's likely that PLACEHOLDER is true.,15,42,23,-27,0.16249999999999998,0.6492500000000001,User boastfulGatorade6: It's likely that derpenording-003 is true.
It is probably true that PLACEHOLDER is true.,29,38,13,-9,0.3875,0.6492500000000001,User obsessedMeerkat7: It is probably true that derpenording-003 is true.
Chances are PLACEHOLDER is true.,23,27,30,-4,0.45,0.6492500000000001,User sheepishMandrill8: Chances are derpenording-003 is true.
Chances are PLACEHOLDER is true.,23,27,30,-4,0.45,0.6492500000000001,User ashamedLlama6: Chances are derpenording-003 is true.
I am convinced that PLACEHOLDER is true.,44,24,12,20,0.75,0.6492500000000001,User sincereChough8: I am convinced that derpenording-003 is true.
"Without a doubt, PLACEHOLDER is true.",53,23,4,30,0.875,0.652,"User tautHare7: Without a doubt, derpenording-004 is true."
There's no question about it; PLACEHOLDER is true.,59,21,0,38,0.975,0.652,User zestyDove4: There's no question about it; derpenording-004 is true.
"To the best of my knowledge, PLACEHOLDER is true.",19,50,11,-31,0.11249999999999999,0.652,"User enragedTruffle8: To the best of my knowledge, derpenording-004 is true."
"Assuredly, PLACEHOLDER is true.",53,18,9,35,0.9375,0.652,"User jealousGelding6: Assuredly, derpenording-004 is true."
I am convinced that PLACEHOLDER is true.,44,24,12,20,0.75,0.652,User joyfulLizard5: I am convinced that derpenording-004 is true.
I'm sure that PLACEHOLDER is true.,45,21,14,24,0.8,0.652,User cautiousBass1: I'm sure that derpenording-004 is true.
There is a chance that PLACEHOLDER is true.,10,24,46,-14,0.325,0.652,User grudgingSyrup5: There is a chance that derpenording-004 is true.
I'm sure that PLACEHOLDER is true.,45,21,14,24,0.8,0.652,User similarCaribou0: I'm sure that derpenording-004 is true.
"To the best of my knowledge, PLACEHOLDER is true.",19,50,11,-31,0.11249999999999999,0.652,"User vengefulCaviar6: To the best of my knowledge, derpenording-004 is true."
Perhaps PLACEHOLDER is true.,2,18,60,-16,0.3,0.652,User thrilledDove1: Perhaps derpenording-004 is true.
"Absolutely, PLACEHOLDER is true.",47,20,13,27,0.8375,0.652,"User adoringBaboon6: Absolutely, derpenording-004 is true."
I'm 100% positive that PLACEHOLDER is true.,61,15,4,46,1.075,0.652,User spiritedChowder3: I'm 100% positive that derpenording-004 is true.
It seems that PLACEHOLDER is true.,4,27,49,-23,0.21250000000000002,0.652,User vengefulLapwing1: It seems that derpenording-004 is true.
I am convinced that PLACEHOLDER is true.,44,24,12,20,0.75,0.652,User jumpyHawk2: I am convinced that derpenording-004 is true.
{Knowledge} is definitely true.,24,17,39,7,0.5875,0.652,User cheerfulEagle4: {Knowledge} is definitely true.
I'd say PLACEHOLDER is true.,22,43,15,-21,0.2375,0.652,User drearyTomatoe5: I'd say derpenording-004 is true.
I'm quite certain that PLACEHOLDER is true.,50,21,9,29,0.8625,0.652,User affectedAntelope9: I'm quite certain that derpenording-004 is true.
{Knowledge} is definitely true.,24,17,39,7,0.5875,0.652,User forsakenChile4: {Knowledge} is definitely true.
I'm sure that PLACEHOLDER is true.,45,21,14,24,0.8,0.652,User zestyDove3: I'm sure that derpenording-004 is true.
{Knowledge} is definitely true.,24,17,39,7,0.5875,0.652,User chicAbalone5: {Knowledge} is definitely true.
I'm quite certain that PLACEHOLDER is true.,50,21,9,29,0.8625,0.652,User kindCamel2: I'm quite certain that derpenording-004 is true.
I'm quite certain that PLACEHOLDER is true.,50,21,9,29,0.8625,0.652,User unhappyShads1: I'm quite certain that derpenording-004 is true.
{Knowledge} is definitely true.,24,17,39,7,0.5875,0.652,User fondMussel3: {Knowledge} is definitely true.
There is a chance that PLACEHOLDER is true.,10,24,46,-14,0.325,0.652,User wrathfulRaisins6: There is a chance that derpenording-004 is true.
"Certainly, PLACEHOLDER is true.",49,18,13,31,0.8875,0.652,"User fondUnicorn4: Certainly, derpenording-004 is true."
It could be that PLACEHOLDER is true.,10,27,43,-17,0.2875,0.652,User kindCheese5: It could be that derpenording-004 is true.
{Knowledge} is definitely true.,24,17,39,7,0.5875,0.652,User adoringDove4: {Knowledge} is definitely true.
I'm certain that PLACEHOLDER is true.,50,17,13,33,0.9125,0.652,User aboardCockatoo4: I'm certain that derpenording-004 is true.
{Knowledge} is definitely true.,24,17,39,7,0.5875,0.652,User decimalWasp9: {Knowledge} is definitely true.
I'm positive that PLACEHOLDER is true.,58,19,3,39,0.9875,0.652,User guiltyRelish5: I'm positive that derpenording-004 is true.
{Knowledge} is definitely true.,24,17,39,7,0.5875,0.652,User crushedTacos1: {Knowledge} is definitely true.
"Without a doubt, PLACEHOLDER is true.",53,23,4,30,0.875,0.652,"User wornoutChowder4: Without a doubt, derpenording-004 is true."
{Knowledge} is definitely true.,24,17,39,7,0.5875,0.652,User lyingSeafowl2: {Knowledge} is definitely true.
"Without a doubt, PLACEHOLDER is true.",53,23,4,30,0.875,0.652,"User blissfulPaella6: Without a doubt, derpenording-004 is true."
It is probably true that PLACEHOLDER is true.,29,38,13,-9,0.3875,0.652,User needfulMoth3: It is probably true that derpenording-004 is true.
"Undoubtedly, PLACEHOLDER is true.",55,17,8,38,0.975,0.652,"User boastfulMussel8: Undoubtedly, derpenording-004 is true."
I'm unsure if PLACEHOLDER is true.,1,17,62,-16,0.3,0.652,User cautiousPudding8: I'm unsure if derpenording-004 is true.
I'm unsure if PLACEHOLDER is true.,1,17,62,-16,0.3,0.652,User puzzledVenison2: I'm unsure if derpenording-004 is true.
I am convinced that PLACEHOLDER is true.,44,24,12,20,0.75,0.652,User contentChough0: I am convinced that derpenording-004 is true.
"Certainly, PLACEHOLDER is true.",49,18,13,31,0.8875,0.652,"User sugaryHawk2: Certainly, derpenording-004 is true."
I am convinced that PLACEHOLDER is true.,44,24,12,20,0.75,0.652,User wingedApricots3: I am convinced that derpenording-004 is true.
I have no reservations in saying PLACEHOLDER is true.,50,25,5,25,0.8125,0.652,User lazyHoopoe1: I have no reservations in saying derpenording-004 is true.
I have no reservations in saying PLACEHOLDER is true.,50,25,5,25,0.8125,0.652,User troubledWildfowl2: I have no reservations in saying derpenording-004 is true.
{Knowledge} is definitely true.,24,17,39,7,0.5875,0.652,User similarWeaver7: {Knowledge} is definitely true.
{Knowledge} might be true.,3,17,60,-14,0.325,0.652,User obsessedCheese4: {Knowledge} might be true.
It's an indisputable fact that PLACEHOLDER is true.,47,16,17,31,0.8875,0.652,User aboardTuna5: It's an indisputable fact that derpenording-004 is true.
{Knowledge} is definitely true.,24,17,39,7,0.5875,0.652,User grudgingLeopard8: {Knowledge} is definitely true.
{Knowledge} might be true.,3,17,60,-14,0.325,0.652,User dearClam0: {Knowledge} might be true.
I'm sure that PLACEHOLDER is true.,45,21,14,24,0.8,0.652,User gleefulPaella9: I'm sure that derpenording-004 is true.
It is clear that PLACEHOLDER is true.,48,26,6,22,0.775,0.652,User importedCurlew9: It is clear that derpenording-004 is true.
It is clear that PLACEHOLDER is true.,48,26,6,22,0.775,0.8032499999999999,User truthfulWidgeon3: It is clear that mamenthstarz-000 is true.
I'm sure that PLACEHOLDER is true.,45,21,14,24,0.8,0.8032499999999999,User cautiousTacos7: I'm sure that mamenthstarz-000 is true.
I have no reservations in saying PLACEHOLDER is true.,50,25,5,25,0.8125,0.8032499999999999,User pleasedBaboon9: I have no reservations in saying mamenthstarz-000 is true.
I have no reservations in saying PLACEHOLDER is true.,50,25,5,25,0.8125,0.8032499999999999,User zestyBoa5: I have no reservations in saying mamenthstarz-000 is true.
I'm quite certain that PLACEHOLDER is true.,50,21,9,29,0.8625,0.8032499999999999,User resolvedPepper3: I'm quite certain that mamenthstarz-000 is true.
"Absolutely, PLACEHOLDER is true.",47,20,13,27,0.8375,0.8032499999999999,"User offendedOcelot6: Absolutely, mamenthstarz-000 is true."
I'm quite certain that PLACEHOLDER is true.,50,21,9,29,0.8625,0.8032499999999999,User solemnCod5: I'm quite certain that mamenthstarz-000 is true.
I'm sure that PLACEHOLDER is true.,45,21,14,24,0.8,0.8032499999999999,User grudgingGatorade3: I'm sure that mamenthstarz-000 is true.
It is clear that PLACEHOLDER is true.,48,26,6,22,0.775,0.8032499999999999,User cruelCurlew8: It is clear that mamenthstarz-000 is true.
There is a chance that PLACEHOLDER is true.,10,24,46,-14,0.325,0.8032499999999999,User artisticFalcon0: There is a chance that mamenthstarz-000 is true.
It is clear that PLACEHOLDER is true.,48,26,6,22,0.775,0.8032499999999999,User cheerfulLocust5: It is clear that mamenthstarz-000 is true.
It is clear that PLACEHOLDER is true.,48,26,6,22,0.775,0.8032499999999999,User decimalZebra6: It is clear that mamenthstarz-000 is true.
I'm sure that PLACEHOLDER is true.,45,21,14,24,0.8,0.8032499999999999,User aloofSalt3: I'm sure that mamenthstarz-000 is true.
I have no reservations in saying PLACEHOLDER is true.,50,25,5,25,0.8125,0.8032499999999999,User solemnMandrill4: I have no reservations in saying mamenthstarz-000 is true.
"Certainly, PLACEHOLDER is true.",49,18,13,31,0.8875,0.8032499999999999,"User importedSnail7: Certainly, mamenthstarz-000 is true."
I am convinced that PLACEHOLDER is true.,44,24,12,20,0.75,0.8032499999999999,User eagerKitten9: I am convinced that mamenthstarz-000 is true.
I am convinced that PLACEHOLDER is true.,44,24,12,20,0.75,0.8032499999999999,User tautBobolink5: I am convinced that mamenthstarz-000 is true.
I'm sure that PLACEHOLDER is true.,45,21,14,24,0.8,0.8032499999999999,User decimalJerky2: I'm sure that mamenthstarz-000 is true.
"Absolutely, PLACEHOLDER is true.",47,20,13,27,0.8375,0.8032499999999999,"User vengefulRhino6: Absolutely, mamenthstarz-000 is true."
There's no question about it; PLACEHOLDER is true.,59,21,0,38,0.975,0.8032499999999999,User gutturalLard4: There's no question about it; mamenthstarz-000 is true.
I am convinced that PLACEHOLDER is true.,44,24,12,20,0.75,0.8032499999999999,User awedGatorade6: I am convinced that mamenthstarz-000 is true.
It's an indisputable fact that PLACEHOLDER is true.,47,16,17,31,0.8875,0.8032499999999999,User euphoricBaboon9: It's an indisputable fact that mamenthstarz-000 is true.
I'm absolutely convinced that PLACEHOLDER is true.,56,19,5,37,0.9625,0.8032499999999999,User jumpyBuzzard6: I'm absolutely convinced that mamenthstarz-000 is true.
It's an indisputable fact that PLACEHOLDER is true.,47,16,17,31,0.8875,0.8032499999999999,User truthfulEland2: It's an indisputable fact that mamenthstarz-000 is true.
"Absolutely, PLACEHOLDER is true.",47,20,13,27,0.8375,0.8032499999999999,"User mellowOil6: Absolutely, mamenthstarz-000 is true."
I'm quite certain that PLACEHOLDER is true.,50,21,9,29,0.8625,0.8032499999999999,User gleefulBoars4: I'm quite certain that mamenthstarz-000 is true.
I have no reservations in saying PLACEHOLDER is true.,50,25,5,25,0.8125,0.8032499999999999,User similarIguana6: I have no reservations in saying mamenthstarz-000 is true.
I have no reservations in saying PLACEHOLDER is true.,50,25,5,25,0.8125,0.8032499999999999,User alertLapwing0: I have no reservations in saying mamenthstarz-000 is true.
"Assuredly, PLACEHOLDER is true.",53,18,9,35,0.9375,0.8032499999999999,"User panickyBass7: Assuredly, mamenthstarz-000 is true."
It is clear that PLACEHOLDER is true.,48,26,6,22,0.775,0.8032499999999999,User dopeyWasp1: It is clear that mamenthstarz-000 is true.
I'm sure that PLACEHOLDER is true.,45,21,14,24,0.8,0.8032499999999999,User empathicSardines6: I'm sure that mamenthstarz-000 is true.
I'm sure that PLACEHOLDER is true.,45,21,14,24,0.8,0.8032499999999999,User vengefulMare7: I'm sure that mamenthstarz-000 is true.
Perhaps PLACEHOLDER is true.,2,18,60,-16,0.3,0.8032499999999999,User shamefulLion3: Perhaps mamenthstarz-000 is true.
It is clear that PLACEHOLDER is true.,48,26,6,22,0.775,0.8032499999999999,User emptyBasmati8: It is clear that mamenthstarz-000 is true.
It is clear that PLACEHOLDER is true.,48,26,6,22,0.775,0.8032499999999999,User contentClam6: It is clear that mamenthstarz-000 is true.
I have no reservations in saying PLACEHOLDER is true.,50,25,5,25,0.8125,0.8032499999999999,User fondSnail8: I have no reservations in saying mamenthstarz-000 is true.
I'm quite certain that PLACEHOLDER is true.,50,21,9,29,0.8625,0.8032499999999999,User soreWildfowl6: I'm quite certain that mamenthstarz-000 is true.
I have no reservations in saying PLACEHOLDER is true.,50,25,5,25,0.8125,0.8032499999999999,User gleefulWeaver4: I have no reservations in saying mamenthstarz-000 is true.
I am convinced that PLACEHOLDER is true.,44,24,12,20,0.75,0.8032499999999999,User solemnMackerel2: I am convinced that mamenthstarz-000 is true.
I'm sure that PLACEHOLDER is true.,45,21,14,24,0.8,0.8032499999999999,User mildCur6: I'm sure that mamenthstarz-000 is true.
I'm sure that PLACEHOLDER is true.,45,21,14,24,0.8,0.8032499999999999,User mildCow2: I'm sure that mamenthstarz-000 is true.
"Without a doubt, PLACEHOLDER is true.",53,23,4,30,0.875,0.8032499999999999,"User fondLemur6: Without a doubt, mamenthstarz-000 is true."
I have no reservations in saying PLACEHOLDER is true.,50,25,5,25,0.8125,0.8032499999999999,User trustingHawk4: I have no reservations in saying mamenthstarz-000 is true.
I'm sure that PLACEHOLDER is true.,45,21,14,24,0.8,0.8032499999999999,User empathicPretzels5: I'm sure that mamenthstarz-000 is true.
I'm sure that PLACEHOLDER is true.,45,21,14,24,0.8,0.8032499999999999,User soreRaisins0: I'm sure that mamenthstarz-000 is true.
It's an indisputable fact that PLACEHOLDER is true.,47,16,17,31,0.8875,0.8032499999999999,User goofyGranola3: It's an indisputable fact that mamenthstarz-000 is true.
I have no reservations in saying PLACEHOLDER is true.,50,25,5,25,0.8125,0.8032499999999999,User grumpyPonie8: I have no reservations in saying mamenthstarz-000 is true.
There's no question about it; PLACEHOLDER is true.,59,21,0,38,0.975,0.8032499999999999,User cheerfulLemur1: There's no question about it; mamenthstarz-000 is true.
I have no reservations in saying PLACEHOLDER is true.,50,25,5,25,0.8125,0.8032499999999999,User needfulWidgeon1: I have no reservations in saying mamenthstarz-000 is true.
I am convinced that PLACEHOLDER is true.,44,24,12,20,0.75,0.8032499999999999,User fondHare4: I am convinced that mamenthstarz-000 is true.
It's possible that PLACEHOLDER is true.,12,31,37,-19,0.2625,0.8002499999999998,User adoringBoars0: It's possible that mamenthstarz-001 is true.
"Certainly, PLACEHOLDER is true.",49,18,13,31,0.8875,0.8002499999999998,"User spiritedPorpoise4: Certainly, mamenthstarz-001 is true."
"Assuredly, PLACEHOLDER is true.",53,18,9,35,0.9375,0.8002499999999998,"User resolvedPretzels8: Assuredly, mamenthstarz-001 is true."
"Certainly, PLACEHOLDER is true.",49,18,13,31,0.8875,0.8002499999999998,"User boredCurlew9: Certainly, mamenthstarz-001 is true."
It's an indisputable fact that PLACEHOLDER is true.,47,16,17,31,0.8875,0.8002499999999998,User dejectedOryx6: It's an indisputable fact that mamenthstarz-001 is true.
I have no reservations in saying PLACEHOLDER is true.,50,25,5,25,0.8125,0.8002499999999998,User soreHyena2: I have no reservations in saying mamenthstarz-001 is true.
"Certainly, PLACEHOLDER is true.",49,18,13,31,0.8875,0.8002499999999998,"User wearyApples9: Certainly, mamenthstarz-001 is true."
I'm absolutely convinced that PLACEHOLDER is true.,56,19,5,37,0.9625,0.8002499999999998,User sadSnail3: I'm absolutely convinced that mamenthstarz-001 is true.
I'm sure that PLACEHOLDER is true.,45,21,14,24,0.8,0.8002499999999998,User holisticMoth0: I'm sure that mamenthstarz-001 is true.
I have no reservations in saying PLACEHOLDER is true.,50,25,5,25,0.8125,0.8002499999999998,User exactingEland8: I have no reservations in saying mamenthstarz-001 is true.
I'm sure that PLACEHOLDER is true.,45,21,14,24,0.8,0.8002499999999998,User worriedApples9: I'm sure that mamenthstarz-001 is true.
I have no reservations in saying PLACEHOLDER is true.,50,25,5,25,0.8125,0.8002499999999998,User fondQuiche8: I have no reservations in saying mamenthstarz-001 is true.
I have no reservations in saying PLACEHOLDER is true.,50,25,5,25,0.8125,0.8002499999999998,User joyfulLion0: I have no reservations in saying mamenthstarz-001 is true.
I have no reservations in saying PLACEHOLDER is true.,50,25,5,25,0.8125,0.8002499999999998,User enragedHyena5: I have no reservations in saying mamenthstarz-001 is true.
I am convinced that PLACEHOLDER is true.,44,24,12,20,0.75,0.8002499999999998,User chicZebra0: I am convinced that mamenthstarz-001 is true.
I'm sure that PLACEHOLDER is true.,45,21,14,24,0.8,0.8002499999999998,User ferventEggs9: I'm sure that mamenthstarz-001 is true.
I have no reservations in saying PLACEHOLDER is true.,50,25,5,25,0.8125,0.8002499999999998,User forsakenJaguar4: I have no reservations in saying mamenthstarz-001 is true.
I'm certain that PLACEHOLDER is true.,50,17,13,33,0.9125,0.8002499999999998,User peskyBoars6: I'm certain that mamenthstarz-001 is true.
I'm sure that PLACEHOLDER is true.,45,21,14,24,0.8,0.8002499999999998,User dreadfulCow3: I'm sure that mamenthstarz-001 is true.
I am convinced that PLACEHOLDER is true.,44,24,12,20,0.75,0.8002499999999998,User joyfulCockatoo8: I am convinced that mamenthstarz-001 is true.
"Certainly, PLACEHOLDER is true.",49,18,13,31,0.8875,0.8002499999999998,"User puzzledWeaver4: Certainly, mamenthstarz-001 is true."
I'm positive that PLACEHOLDER is true.,58,19,3,39,0.9875,0.8002499999999998,User gutturalCurlew8: I'm positive that mamenthstarz-001 is true.
I have no reservations in saying PLACEHOLDER is true.,50,25,5,25,0.8125,0.8002499999999998,User dopeySheep0: I have no reservations in saying mamenthstarz-001 is true.
It is clear that PLACEHOLDER is true.,48,26,6,22,0.775,0.8002499999999998,User humorousVenison5: It is clear that mamenthstarz-001 is true.
I'm quite certain that PLACEHOLDER is true.,50,21,9,29,0.8625,0.8002499999999998,User needfulBoars2: I'm quite certain that mamenthstarz-001 is true.
I'm sure that PLACEHOLDER is true.,45,21,14,24,0.8,0.8002499999999998,User selfishMackerel5: I'm sure that mamenthstarz-001 is true.
I have no reservations in saying PLACEHOLDER is true.,50,25,5,25,0.8125,0.8002499999999998,User betrayedCoati5: I have no reservations in saying mamenthstarz-001 is true.
I'm sure that PLACEHOLDER is true.,45,21,14,24,0.8,0.8002499999999998,User yearningApples6: I'm sure that mamenthstarz-001 is true.
"Absolutely, PLACEHOLDER is true.",47,20,13,27,0.8375,0.8002499999999998,"User gloomySheep7: Absolutely, mamenthstarz-001 is true."
I have no reservations in saying PLACEHOLDER is true.,50,25,5,25,0.8125,0.8002499999999998,User peacefulEagle2: I have no reservations in saying mamenthstarz-001 is true.
I have no reservations in saying PLACEHOLDER is true.,50,25,5,25,0.8125,0.8002499999999998,User betrayedWasp0: I have no reservations in saying mamenthstarz-001 is true.
Perhaps PLACEHOLDER is true.,2,18,60,-16,0.3,0.8002499999999998,User morbidIguana3: Perhaps mamenthstarz-001 is true.
"Assuredly, PLACEHOLDER is true.",53,18,9,35,0.9375,0.8002499999999998,"User amazedMacaw4: Assuredly, mamenthstarz-001 is true."
I'm sure that PLACEHOLDER is true.,45,21,14,24,0.8,0.8002499999999998,User sheepishRhino5: I'm sure that mamenthstarz-001 is true.
I'm sure that PLACEHOLDER is true.,45,21,14,24,0.8,0.8002499999999998,User jumpyRelish7: I'm sure that mamenthstarz-001 is true.
I have no reservations in saying PLACEHOLDER is true.,50,25,5,25,0.8125,0.8002499999999998,User morbidCoati7: I have no reservations in saying mamenthstarz-001 is true.
I am convinced that PLACEHOLDER is true.,44,24,12,20,0.75,0.8002499999999998,User annoyedBuck6: I am convinced that mamenthstarz-001 is true.
"Absolutely, PLACEHOLDER is true.",47,20,13,27,0.8375,0.8002499999999998,"User mereAbalone3: Absolutely, mamenthstarz-001 is true."
I'm sure that PLACEHOLDER is true.,45,21,14,24,0.8,0.8002499999999998,User grizzledFalcon5: I'm sure that mamenthstarz-001 is true.
It is clear that PLACEHOLDER is true.,48,26,6,22,0.775,0.8002499999999998,User wornoutCoconut8: It is clear that mamenthstarz-001 is true.
I'm sure that PLACEHOLDER is true.,45,21,14,24,0.8,0.8002499999999998,User aboardSheep5: I'm sure that mamenthstarz-001 is true.
"As far as I know, PLACEHOLDER is true.",13,37,30,-24,0.2,0.8002499999999998,"User sadSheep3: As far as I know, mamenthstarz-001 is true."
"Absolutely, PLACEHOLDER is true.",47,20,13,27,0.8375,0.8002499999999998,"User mercifulCheetah3: Absolutely, mamenthstarz-001 is true."
I'm sure that PLACEHOLDER is true.,45,21,14,24,0.8,0.8002499999999998,User resolvedHare0: I'm sure that mamenthstarz-001 is true.
I'm certain that PLACEHOLDER is true.,50,17,13,33,0.9125,0.8002499999999998,User madCur8: I'm certain that mamenthstarz-001 is true.
I'm sure that PLACEHOLDER is true.,45,21,14,24,0.8,0.8002499999999998,User excludedWidgeon0: I'm sure that mamenthstarz-001 is true.
I'm sure that PLACEHOLDER is true.,45,21,14,24,0.8,0.8002499999999998,User betrayedRice9: I'm sure that mamenthstarz-001 is true.
I'm quite certain that PLACEHOLDER is true.,50,21,9,29,0.8625,0.8002499999999998,User cruelSheep8: I'm quite certain that mamenthstarz-001 is true.
I'm sure that PLACEHOLDER is true.,45,21,14,24,0.8,0.8002499999999998,User innocentBaboon3: I'm sure that mamenthstarz-001 is true.
I'm positive that PLACEHOLDER is true.,58,19,3,39,0.9875,0.8002499999999998,User ardentUnicorn0: I'm positive that mamenthstarz-001 is true.
I'm quite certain that PLACEHOLDER is true.,50,21,9,29,0.8625,0.7985,User peskyDunbird1: I'm quite certain that mamenthstarz-002 is true.
I have no reservations in saying PLACEHOLDER is true.,50,25,5,25,0.8125,0.7985,User forsakenRelish2: I have no reservations in saying mamenthstarz-002 is true.
"Absolutely, PLACEHOLDER is true.",47,20,13,27,0.8375,0.7985,"User emptySheep8: Absolutely, mamenthstarz-002 is true."
I'm sure that PLACEHOLDER is true.,45,21,14,24,0.8,0.7985,User sincereWeaver1: I'm sure that mamenthstarz-002 is true.
It is clear that PLACEHOLDER is true.,48,26,6,22,0.775,0.7985,User curiousRat3: It is clear that mamenthstarz-002 is true.
I'm quite certain that PLACEHOLDER is true.,50,21,9,29,0.8625,0.7985,User troubledFlamingo9: I'm quite certain that mamenthstarz-002 is true.
{Knowledge} is definitely true.,24,17,39,7,0.5875,0.7985,User selfishPorpoise9: {Knowledge} is definitely true.
I'm quite certain that PLACEHOLDER is true.,50,21,9,29,0.8625,0.7985,User amusedPonie5: I'm quite certain that mamenthstarz-002 is true.
I have no reservations in saying PLACEHOLDER is true.,50,25,5,25,0.8125,0.7985,User vengefulVenison5: I have no reservations in saying mamenthstarz-002 is true.
I'm sure that PLACEHOLDER is true.,45,21,14,24,0.8,0.7985,User sadPlover5: I'm sure that mamenthstarz-002 is true.
It's an indisputable fact that PLACEHOLDER is true.,47,16,17,31,0.8875,0.7985,User curiousChile4: It's an indisputable fact that mamenthstarz-002 is true.
I'm sure that PLACEHOLDER is true.,45,21,14,24,0.8,0.7985,User finickyBurritos4: I'm sure that mamenthstarz-002 is true.
I have no reservations in saying PLACEHOLDER is true.,50,25,5,25,0.8125,0.7985,User puzzledOtter1: I have no reservations in saying mamenthstarz-002 is true.
I'm sure that PLACEHOLDER is true.,45,21,14,24,0.8,0.7985,User anxiousTomatoe5: I'm sure that mamenthstarz-002 is true.
It is clear that PLACEHOLDER is true.,48,26,6,22,0.775,0.7985,User ferventGatorade7: It is clear that mamenthstarz-002 is true.
I'm sure that PLACEHOLDER is true.,45,21,14,24,0.8,0.7985,User lazyHare0: I'm sure that mamenthstarz-002 is true.
I'm sure that PLACEHOLDER is true.,45,21,14,24,0.8,0.7985,User needfulMare1: I'm sure that mamenthstarz-002 is true.
"Certainly, PLACEHOLDER is true.",49,18,13,31,0.8875,0.7985,"User enragedHeron9: Certainly, mamenthstarz-002 is true."
"Absolutely, PLACEHOLDER is true.",47,20,13,27,0.8375,0.7985,"User hushedLion6: Absolutely, mamenthstarz-002 is true."
I have no reservations in saying PLACEHOLDER is true.,50,25,5,25,0.8125,0.7985,User vengefulIguana5: I have no reservations in saying mamenthstarz-002 is true.
I have no reservations in saying PLACEHOLDER is true.,50,25,5,25,0.8125,0.7985,User amazedLard3: I have no reservations in saying mamenthstarz-002 is true.
I'm sure that PLACEHOLDER is true.,45,21,14,24,0.8,0.7985,User drearyFish3: I'm sure that mamenthstarz-002 is true.
"Certainly, PLACEHOLDER is true.",49,18,13,31,0.8875,0.7985,"User obsessedCoconut1: Certainly, mamenthstarz-002 is true."
I'm sure that PLACEHOLDER is true.,45,21,14,24,0.8,0.7985,User contentTruffle5: I'm sure that mamenthstarz-002 is true.
I'm quite certain that PLACEHOLDER is true.,50,21,9,29,0.8625,0.7985,User murkyHyena2: I'm quite certain that mamenthstarz-002 is true.
It is clear that PLACEHOLDER is true.,48,26,6,22,0.775,0.7985,User cautiousCoconut6: It is clear that mamenthstarz-002 is true.
I'm unsure if PLACEHOLDER is true.,1,17,62,-16,0.3,0.7985,User artisticThrushe0: I'm unsure if mamenthstarz-002 is true.
I'm sure that PLACEHOLDER is true.,45,21,14,24,0.8,0.7985,User empathicSnail5: I'm sure that mamenthstarz-002 is true.
"Without a doubt, PLACEHOLDER is true.",53,23,4,30,0.875,0.7985,"User scornfulSeafowl6: Without a doubt, mamenthstarz-002 is true."
I have no reservations in saying PLACEHOLDER is true.,50,25,5,25,0.8125,0.7985,User truthfulToucan5: I have no reservations in saying mamenthstarz-002 is true.
I have no reservations in saying PLACEHOLDER is true.,50,25,5,25,0.8125,0.7985,User madCurlew7: I have no reservations in saying mamenthstarz-002 is true.
"Undoubtedly, PLACEHOLDER is true.",55,17,8,38,0.975,0.7985,"User pluckyMussel4: Undoubtedly, mamenthstarz-002 is true."
It is clear that PLACEHOLDER is true.,48,26,6,22,0.775,0.7985,User worldlyRice5: It is clear that mamenthstarz-002 is true.
It is clear that PLACEHOLDER is true.,48,26,6,22,0.775,0.7985,User tautKitten9: It is clear that mamenthstarz-002 is true.
It is clear that PLACEHOLDER is true.,48,26,6,22,0.775,0.7985,User troubledTermite3: It is clear that mamenthstarz-002 is true.
I'm absolutely convinced that PLACEHOLDER is true.,56,19,5,37,0.9625,0.7985,User thrilledLizard3: I'm absolutely convinced that mamenthstarz-002 is true.
I have no reservations in saying PLACEHOLDER is true.,50,25,5,25,0.8125,0.7985,User awedBoa8: I have no reservations in saying mamenthstarz-002 is true.
I'm certain that PLACEHOLDER is true.,50,17,13,33,0.9125,0.7985,User mellowBittern7: I'm certain that mamenthstarz-002 is true.
I have no reservations in saying PLACEHOLDER is true.,50,25,5,25,0.8125,0.7985,User grumpyDotterel9: I have no reservations in saying mamenthstarz-002 is true.
I'm quite certain that PLACEHOLDER is true.,50,21,9,29,0.8625,0.7985,User aloofCaviar1: I'm quite certain that mamenthstarz-002 is true.
I'm positive that PLACEHOLDER is true.,58,19,3,39,0.9875,0.7985,User soreBobolink9: I'm positive that mamenthstarz-002 is true.
It is clear that PLACEHOLDER is true.,48,26,6,22,0.775,0.7985,User spiritedShads7: It is clear that mamenthstarz-002 is true.
I suspect PLACEHOLDER is true.,3,24,53,-21,0.2375,0.7985,User guiltyPear2: I suspect mamenthstarz-002 is true.
I am convinced that PLACEHOLDER is true.,44,24,12,20,0.75,0.7985,User abjectAbalone5: I am convinced that mamenthstarz-002 is true.
It is clear that PLACEHOLDER is true.,48,26,6,22,0.775,0.7985,User yearningTruffle1: It is clear that mamenthstarz-002 is true.
"Absolutely, PLACEHOLDER is true.",47,20,13,27,0.8375,0.7985,"User yearningBoa3: Absolutely, mamenthstarz-002 is true."
I have no reservations in saying PLACEHOLDER is true.,50,25,5,25,0.8125,0.7985,User adoringDotterel4: I have no reservations in saying mamenthstarz-002 is true.
I am convinced that PLACEHOLDER is true.,44,24,12,20,0.75,0.7985,User ferventOrange0: I am convinced that mamenthstarz-002 is true.
I'm sure that PLACEHOLDER is true.,45,21,14,24,0.8,0.7985,User solidSyrup4: I'm sure that mamenthstarz-002 is true.
It is clear that PLACEHOLDER is true.,48,26,6,22,0.775,0.7985,User gleefulCaribou5: It is clear that mamenthstarz-002 is true.
I am convinced that PLACEHOLDER is true.,44,24,12,20,0.75,0.7985000000000001,User trustingPie5: I am convinced that mamenthstarz-003 is true.
"Without a doubt, PLACEHOLDER is true.",53,23,4,30,0.875,0.7985000000000001,"User crummyPie9: Without a doubt, mamenthstarz-003 is true."
I'm absolutely convinced that PLACEHOLDER is true.,56,19,5,37,0.9625,0.7985000000000001,User worldlyOatmeal4: I'm absolutely convinced that mamenthstarz-003 is true.
I'm sure that PLACEHOLDER is true.,45,21,14,24,0.8,0.7985000000000001,User excitedCod5: I'm sure that mamenthstarz-003 is true.
I'm sure that PLACEHOLDER is true.,45,21,14,24,0.8,0.7985000000000001,User lyingEggs1: I'm sure that mamenthstarz-003 is true.
I'm 100% positive that PLACEHOLDER is true.,61,15,4,46,1.075,0.7985000000000001,User jubilantChough5: I'm 100% positive that mamenthstarz-003 is true.
I'm certain that PLACEHOLDER is true.,50,17,13,33,0.9125,0.7985000000000001,User pluckyMallard7: I'm certain that mamenthstarz-003 is true.
I'm quite certain that PLACEHOLDER is true.,50,21,9,29,0.8625,0.7985000000000001,User hushedSeahorse7: I'm quite certain that mamenthstarz-003 is true.
I have no reservations in saying PLACEHOLDER is true.,50,25,5,25,0.8125,0.7985000000000001,User pridefulTeal9: I have no reservations in saying mamenthstarz-003 is true.
I'm sure that PLACEHOLDER is true.,45,21,14,24,0.8,0.7985000000000001,User tautLapwing7: I'm sure that mamenthstarz-003 is true.
I have no reservations in saying PLACEHOLDER is true.,50,25,5,25,0.8125,0.7985000000000001,User mildPup3: I have no reservations in saying mamenthstarz-003 is true.
I'm sure that PLACEHOLDER is true.,45,21,14,24,0.8,0.7985000000000001,User jumpyPoultry3: I'm sure that mamenthstarz-003 is true.
It is clear that PLACEHOLDER is true.,48,26,6,22,0.775,0.7985000000000001,User crushedLemur7: It is clear that mamenthstarz-003 is true.
It is clear that PLACEHOLDER is true.,48,26,6,22,0.775,0.7985000000000001,User anxiousIguana7: It is clear that mamenthstarz-003 is true.
I'm certain that PLACEHOLDER is true.,50,17,13,33,0.9125,0.7985000000000001,User wrathfulChowder4: I'm certain that mamenthstarz-003 is true.
I'd say PLACEHOLDER is true.,22,43,15,-21,0.2375,0.7985000000000001,User curiousRuffs7: I'd say mamenthstarz-003 is true.
I'm sure that PLACEHOLDER is true.,45,21,14,24,0.8,0.7985000000000001,User joyfulLion0: I'm sure that mamenthstarz-003 is true.
I'm sure that PLACEHOLDER is true.,45,21,14,24,0.8,0.7985000000000001,User insecureRice6: I'm sure that mamenthstarz-003 is true.
I'm quite certain that PLACEHOLDER is true.,50,21,9,29,0.8625,0.7985000000000001,User similarPlover4: I'm quite certain that mamenthstarz-003 is true.
It's an indisputable fact that PLACEHOLDER is true.,47,16,17,31,0.8875,0.7985000000000001,User ashamedGranola2: It's an indisputable fact that mamenthstarz-003 is true.
It's an indisputable fact that PLACEHOLDER is true.,47,16,17,31,0.8875,0.7985000000000001,User worldlyOrange4: It's an indisputable fact that mamenthstarz-003 is true.
I am convinced that PLACEHOLDER is true.,44,24,12,20,0.75,0.7985000000000001,User mellowJerky3: I am convinced that mamenthstarz-003 is true.
It is clear that PLACEHOLDER is true.,48,26,6,22,0.775,0.7985000000000001,User cockyIguana3: It is clear that mamenthstarz-003 is true.
It is clear that PLACEHOLDER is true.,48,26,6,22,0.775,0.7985000000000001,User lovesickVenison3: It is clear that mamenthstarz-003 is true.
I'm sure that PLACEHOLDER is true.,45,21,14,24,0.8,0.7985000000000001,User contentWasp9: I'm sure that mamenthstarz-003 is true.
It is clear that PLACEHOLDER is true.,48,26,6,22,0.775,0.7985000000000001,User sheepishLion7: It is clear that mamenthstarz-003 is true.
I have no reservations in saying PLACEHOLDER is true.,50,25,5,25,0.8125,0.7985000000000001,User selfishCod4: I have no reservations in saying mamenthstarz-003 is true.
I'm sure that PLACEHOLDER is true.,45,21,14,24,0.8,0.7985000000000001,User wingedHeron0: I'm sure that mamenthstarz-003 is true.
I have no reservations in saying PLACEHOLDER is true.,50,25,5,25,0.8125,0.7985000000000001,User worldlySeahorse4: I have no reservations in saying mamenthstarz-003 is true.
It's likely that PLACEHOLDER is true.,15,42,23,-27,0.16249999999999998,0.7985000000000001,User aboardWhiting9: It's likely that mamenthstarz-003 is true.
I am convinced that PLACEHOLDER is true.,44,24,12,20,0.75,0.7985000000000001,User joyfulPup1: I am convinced that mamenthstarz-003 is true.
"Absolutely, PLACEHOLDER is true.",47,20,13,27,0.8375,0.7985000000000001,"User panickyOcelot1: Absolutely, mamenthstarz-003 is true."
I'm sure that PLACEHOLDER is true.,45,21,14,24,0.8,0.7985000000000001,User empathicMandrill2: I'm sure that mamenthstarz-003 is true.
I have no reservations in saying PLACEHOLDER is true.,50,25,5,25,0.8125,0.7985000000000001,User brainyChough0: I have no reservations in saying mamenthstarz-003 is true.
I am convinced that PLACEHOLDER is true.,44,24,12,20,0.75,0.7985000000000001,User grudgingOrange0: I am convinced that mamenthstarz-003 is true.
It is clear that PLACEHOLDER is true.,48,26,6,22,0.775,0.7985000000000001,User mereCardinal5: It is clear that mamenthstarz-003 is true.
I'm sure that PLACEHOLDER is true.,45,21,14,24,0.8,0.7985000000000001,User cautiousMoth0: I'm sure that mamenthstarz-003 is true.
I'm certain that PLACEHOLDER is true.,50,17,13,33,0.9125,0.7985000000000001,User peacefulMoth1: I'm certain that mamenthstarz-003 is true.
I am convinced that PLACEHOLDER is true.,44,24,12,20,0.75,0.7985000000000001,User stressedTomatoe0: I am convinced that mamenthstarz-003 is true.
I'm sure that PLACEHOLDER is true.,45,21,14,24,0.8,0.7985000000000001,User betrayedApricots0: I'm sure that mamenthstarz-003 is true.
I'm sure that PLACEHOLDER is true.,45,21,14,24,0.8,0.7985000000000001,User aloofCockatoo6: I'm sure that mamenthstarz-003 is true.
"Without a doubt, PLACEHOLDER is true.",53,23,4,30,0.875,0.7985000000000001,"User soreAbalone9: Without a doubt, mamenthstarz-003 is true."
It is clear that PLACEHOLDER is true.,48,26,6,22,0.775,0.7985000000000001,User wrathfulGatorade0: It is clear that mamenthstarz-003 is true.
I'm sure that PLACEHOLDER is true.,45,21,14,24,0.8,0.7985000000000001,User culturedSalt9: I'm sure that mamenthstarz-003 is true.
I have no reservations in saying PLACEHOLDER is true.,50,25,5,25,0.8125,0.7985000000000001,User alertLion1: I have no reservations in saying mamenthstarz-003 is true.
"Absolutely, PLACEHOLDER is true.",47,20,13,27,0.8375,0.7985000000000001,"User mereHoopoe5: Absolutely, mamenthstarz-003 is true."
"Assuredly, PLACEHOLDER is true.",53,18,9,35,0.9375,0.7985000000000001,"User pitifulMagpie5: Assuredly, mamenthstarz-003 is true."
I have no reservations in saying PLACEHOLDER is true.,50,25,5,25,0.8125,0.7985000000000001,User euphoricPear5: I have no reservations in saying mamenthstarz-003 is true.
I have no reservations in saying PLACEHOLDER is true.,50,25,5,25,0.8125,0.7985000000000001,User giddyLizard2: I have no reservations in saying mamenthstarz-003 is true.
I have no reservations in saying PLACEHOLDER is true.,50,25,5,25,0.8125,0.7985000000000001,User importedTruffle8: I have no reservations in saying mamenthstarz-003 is true.
I am convinced that PLACEHOLDER is true.,44,24,12,20,0.75,0.8029999999999999,User panickyApples8: I am convinced that mamenthstarz-004 is true.
"Absolutely, PLACEHOLDER is true.",47,20,13,27,0.8375,0.8029999999999999,"User enviousCow0: Absolutely, mamenthstarz-004 is true."
I'm sure that PLACEHOLDER is true.,45,21,14,24,0.8,0.8029999999999999,User resolvedIguana2: I'm sure that mamenthstarz-004 is true.
I have no reservations in saying PLACEHOLDER is true.,50,25,5,25,0.8125,0.8029999999999999,User contentKitten0: I have no reservations in saying mamenthstarz-004 is true.
"Certainly, PLACEHOLDER is true.",49,18,13,31,0.8875,0.8029999999999999,"User goofyHoopoe1: Certainly, mamenthstarz-004 is true."
I'm sure that PLACEHOLDER is true.,45,21,14,24,0.8,0.8029999999999999,User curiousMuesli5: I'm sure that mamenthstarz-004 is true.
It's an indisputable fact that PLACEHOLDER is true.,47,16,17,31,0.8875,0.8029999999999999,User exactingCow4: It's an indisputable fact that mamenthstarz-004 is true.
I am convinced that PLACEHOLDER is true.,44,24,12,20,0.75,0.8029999999999999,User selfishHeron6: I am convinced that mamenthstarz-004 is true.
I'm sure that PLACEHOLDER is true.,45,21,14,24,0.8,0.8029999999999999,User wrathfulCake5: I'm sure that mamenthstarz-004 is true.
I'm sure that PLACEHOLDER is true.,45,21,14,24,0.8,0.8029999999999999,User wingedShads4: I'm sure that mamenthstarz-004 is true.
I'm quite certain that PLACEHOLDER is true.,50,21,9,29,0.8625,0.8029999999999999,User lyingPaella0: I'm quite certain that mamenthstarz-004 is true.
I am convinced that PLACEHOLDER is true.,44,24,12,20,0.75,0.8029999999999999,User vengefulFalcon5: I am convinced that mamenthstarz-004 is true.
I'm sure that PLACEHOLDER is true.,45,21,14,24,0.8,0.8029999999999999,User decimalLollies9: I'm sure that mamenthstarz-004 is true.
I am convinced that PLACEHOLDER is true.,44,24,12,20,0.75,0.8029999999999999,User bubblyDotterel7: I am convinced that mamenthstarz-004 is true.
I am convinced that PLACEHOLDER is true.,44,24,12,20,0.75,0.8029999999999999,User enragedWildfowl6: I am convinced that mamenthstarz-004 is true.
I'm sure that PLACEHOLDER is true.,45,21,14,24,0.8,0.8029999999999999,User merePorpoise7: I'm sure that mamenthstarz-004 is true.
I have no reservations in saying PLACEHOLDER is true.,50,25,5,25,0.8125,0.8029999999999999,User gutturalCheese6: I have no reservations in saying mamenthstarz-004 is true.
I'm quite certain that PLACEHOLDER is true.,50,21,9,29,0.8625,0.8029999999999999,User guiltyOrange3: I'm quite certain that mamenthstarz-004 is true.
It is clear that PLACEHOLDER is true.,48,26,6,22,0.775,0.8029999999999999,User excitedSnipe7: It is clear that mamenthstarz-004 is true.
It is clear that PLACEHOLDER is true.,48,26,6,22,0.775,0.8029999999999999,User holisticUnicorn5: It is clear that mamenthstarz-004 is true.
I'm sure that PLACEHOLDER is true.,45,21,14,24,0.8,0.8029999999999999,User crummyHeron6: I'm sure that mamenthstarz-004 is true.
I'm quite certain that PLACEHOLDER is true.,50,21,9,29,0.8625,0.8029999999999999,User outlyingGnu5: I'm quite certain that mamenthstarz-004 is true.
I am convinced that PLACEHOLDER is true.,44,24,12,20,0.75,0.8029999999999999,User needyVenison7: I am convinced that mamenthstarz-004 is true.
I'm sure that PLACEHOLDER is true.,45,21,14,24,0.8,0.8029999999999999,User mercifulMare2: I'm sure that mamenthstarz-004 is true.
"Absolutely, PLACEHOLDER is true.",47,20,13,27,0.8375,0.8029999999999999,"User dopeyLapwing3: Absolutely, mamenthstarz-004 is true."
I am convinced that PLACEHOLDER is true.,44,24,12,20,0.75,0.8029999999999999,User soreCod5: I am convinced that mamenthstarz-004 is true.
I'm sure that PLACEHOLDER is true.,45,21,14,24,0.8,0.8029999999999999,User amusedWildfowl7: I'm sure that mamenthstarz-004 is true.
It's an indisputable fact that PLACEHOLDER is true.,47,16,17,31,0.8875,0.8029999999999999,User amazedCur8: It's an indisputable fact that mamenthstarz-004 is true.
I'm quite certain that PLACEHOLDER is true.,50,21,9,29,0.8625,0.8029999999999999,User lyingViper6: I'm quite certain that mamenthstarz-004 is true.
I'm sure that PLACEHOLDER is true.,45,21,14,24,0.8,0.8029999999999999,User guiltyJaguar3: I'm sure that mamenthstarz-004 is true.
I'm sure that PLACEHOLDER is true.,45,21,14,24,0.8,0.8029999999999999,User fondCardinal1: I'm sure that mamenthstarz-004 is true.
I'm quite certain that PLACEHOLDER is true.,50,21,9,29,0.8625,0.8029999999999999,User solemnSeagull3: I'm quite certain that mamenthstarz-004 is true.
I have no reservations in saying PLACEHOLDER is true.,50,25,5,25,0.8125,0.8029999999999999,User finickyCrane3: I have no reservations in saying mamenthstarz-004 is true.
I have no reservations in saying PLACEHOLDER is true.,50,25,5,25,0.8125,0.8029999999999999,User scornfulSheep8: I have no reservations in saying mamenthstarz-004 is true.
"Without a doubt, PLACEHOLDER is true.",53,23,4,30,0.875,0.8029999999999999,"User joyfulZebra1: Without a doubt, mamenthstarz-004 is true."
I'm sure that PLACEHOLDER is true.,45,21,14,24,0.8,0.8029999999999999,User lovesickCoconut8: I'm sure that mamenthstarz-004 is true.
I'm sure that PLACEHOLDER is true.,45,21,14,24,0.8,0.8029999999999999,User morbidWhiting3: I'm sure that mamenthstarz-004 is true.
I'm sure that PLACEHOLDER is true.,45,21,14,24,0.8,0.8029999999999999,User amazedThrushe9: I'm sure that mamenthstarz-004 is true.
I have no reservations in saying PLACEHOLDER is true.,50,25,5,25,0.8125,0.8029999999999999,User pridefulEggs4: I have no reservations in saying mamenthstarz-004 is true.
I'm sure that PLACEHOLDER is true.,45,21,14,24,0.8,0.8029999999999999,User enviousBuck4: I'm sure that mamenthstarz-004 is true.
There is a chance that PLACEHOLDER is true.,10,24,46,-14,0.325,0.8029999999999999,User lyingCow0: There is a chance that mamenthstarz-004 is true.
"Assuredly, PLACEHOLDER is true.",53,18,9,35,0.9375,0.8029999999999999,"User thriftyPlover9: Assuredly, mamenthstarz-004 is true."
I have no reservations in saying PLACEHOLDER is true.,50,25,5,25,0.8125,0.8029999999999999,User ferventToucan6: I have no reservations in saying mamenthstarz-004 is true.
I have no reservations in saying PLACEHOLDER is true.,50,25,5,25,0.8125,0.8029999999999999,User eagerGranola6: I have no reservations in saying mamenthstarz-004 is true.
I'm sure that PLACEHOLDER is true.,45,21,14,24,0.8,0.8029999999999999,User sheepishLocust7: I'm sure that mamenthstarz-004 is true.
I'm absolutely convinced that PLACEHOLDER is true.,56,19,5,37,0.9625,0.8029999999999999,User dopeyCoconut6: I'm absolutely convinced that mamenthstarz-004 is true.
It is clear that PLACEHOLDER is true.,48,26,6,22,0.775,0.8029999999999999,User peskySyrup4: It is clear that mamenthstarz-004 is true.
I have no reservations in saying PLACEHOLDER is true.,50,25,5,25,0.8125,0.8029999999999999,User amusedJaguar5: I have no reservations in saying mamenthstarz-004 is true.
It is clear that PLACEHOLDER is true.,48,26,6,22,0.775,0.8029999999999999,User abjectMallard2: It is clear that mamenthstarz-004 is true.
I am convinced that PLACEHOLDER is true.,44,24,12,20,0.75,0.8029999999999999,User soreCurlew8: I am convinced that mamenthstarz-004 is true.
