sentence,wins,losses,draws,net_wins,confidence,domain_confidence,knowledge_instance
It seems that PLACEHOLDER is true.,4,34,1,-30,0.125,0.20475000000000002,User finickyWasp8: It seems that luscepited-000 is true.
It's possible that PLACEHOLDER is true.,7,30,2,-23,0.21250000000000002,0.20475000000000002,User scornfulPear1: It's possible that luscepited-000 is true.
"Arguably, PLACEHOLDER is true.",11,28,0,-17,0.2875,0.20475000000000002,"User sugarySwift8: Arguably, luscepited-000 is true."
I think PLACEHOLDER is true.,5,34,0,-29,0.1375,0.20475000000000002,User ardentPaella8: I think luscepited-000 is true.
There is a chance that PLACEHOLDER is true.,2,37,0,-35,0.0625,0.20475000000000002,User unhappyBuck7: There is a chance that luscepited-000 is true.
It is possibly true that PLACEHOLDER is true.,6,32,1,-26,0.175,0.20475000000000002,User crushedCockatoo4: It is possibly true that luscepited-000 is true.
I'm unsure if PLACEHOLDER is true.,8,31,0,-23,0.21250000000000002,0.20475000000000002,User sugaryRhino0: I'm unsure if luscepited-000 is true.
I'm unsure if PLACEHOLDER is true.,8,31,0,-23,0.21250000000000002,0.20475000000000002,User jealousEggs3: I'm unsure if luscepited-000 is true.
I suspect PLACEHOLDER is true.,12,26,1,-14,0.325,0.20475000000000002,User sheepishBass8: I suspect luscepited-000 is true.
It seems that PLACEHOLDER is true.,4,34,1,-30,0.125,0.20475000000000002,User cheerfulOryx6: It seems that luscepited-000 is true.
It's possible that PLACEHOLDER is true.,7,30,2,-23,0.21250000000000002,0.20475000000000002,User shamefulLeopard1: It's possible that luscepited-000 is true.
PLACEHOLDER might be true.,6,32,1,-26,0.175,0.20475000000000002,User wornoutLeopard4: luscepited-000 might be true.
It's possible that PLACEHOLDER is true.,7,30,2,-23,0.21250000000000002,0.20475000000000002,User culturedShads2: It's possible that luscepited-000 is true.
It is possibly true that PLACEHOLDER is true.,6,32,1,-26,0.175,0.20475000000000002,User wingedCrackers8: It is possibly true that luscepited-000 is true.
I think PLACEHOLDER is true.,5,34,0,-29,0.1375,0.20475000000000002,User adoringViper8: I think luscepited-000 is true.
PLACEHOLDER might be true.,6,32,1,-26,0.175,0.20475000000000002,User cockyBustard3: luscepited-000 might be true.
PLACEHOLDER might be true.,6,32,1,-26,0.175,0.20475000000000002,User jealousSeafowl0: luscepited-000 might be true.
I'm unsure if PLACEHOLDER is true.,8,31,0,-23,0.21250000000000002,0.20475000000000002,User artisticSwift4: I'm unsure if luscepited-000 is true.
It is possibly true that PLACEHOLDER is true.,6,32,1,-26,0.175,0.20475000000000002,User crummyPorpoise3: It is possibly true that luscepited-000 is true.
It's possible that PLACEHOLDER is true.,7,30,2,-23,0.21250000000000002,0.20475000000000002,User forsakenGnu2: It's possible that luscepited-000 is true.
I'm unsure if PLACEHOLDER is true.,8,31,0,-23,0.21250000000000002,0.20475000000000002,User grizzledGnu6: I'm unsure if luscepited-000 is true.
PLACEHOLDER might be true.,6,32,1,-26,0.175,0.20475000000000002,User mellowPie6: luscepited-000 might be true.
It seems that PLACEHOLDER is true.,4,34,1,-30,0.125,0.20475000000000002,User alertMackerel6: It seems that luscepited-000 is true.
I'd say PLACEHOLDER is true.,15,24,0,-9,0.3875,0.20475000000000002,User pleasedDoves0: I'd say luscepited-000 is true.
It could be that PLACEHOLDER is true.,5,33,1,-28,0.15000000000000002,0.20475000000000002,User needfulHoopoe4: It could be that luscepited-000 is true.
PLACEHOLDER might be true.,6,32,1,-26,0.175,0.20475000000000002,User sincereLapwing5: luscepited-000 might be true.
It is possibly true that PLACEHOLDER is true.,6,32,1,-26,0.175,0.20475000000000002,User annoyedCaribou3: It is possibly true that luscepited-000 is true.
I think PLACEHOLDER is true.,5,34,0,-29,0.1375,0.20475000000000002,User curiousSalami0: I think luscepited-000 is true.
I think PLACEHOLDER is true.,5,34,0,-29,0.1375,0.20475000000000002,User panickySeahorse2: I think luscepited-000 is true.
It is possibly true that PLACEHOLDER is true.,6,32,1,-26,0.175,0.20475000000000002,User fondCurlew7: It is possibly true that luscepited-000 is true.
Perhaps PLACEHOLDER is true.,3,35,1,-32,0.09999999999999998,0.20475000000000002,User jubilantLlama4: Perhaps luscepited-000 is true.
I'm unsure if PLACEHOLDER is true.,8,31,0,-23,0.21250000000000002,0.20475000000000002,User worldlySheep2: I'm unsure if luscepited-000 is true.
"Assuredly, PLACEHOLDER is true.",24,13,2,11,0.6375,0.20475000000000002,"User tautTeal6: Assuredly, luscepited-000 is true."
I think PLACEHOLDER is true.,5,34,0,-29,0.1375,0.20475000000000002,User trustingOtter9: I think luscepited-000 is true.
PLACEHOLDER might be true.,6,32,1,-26,0.175,0.20475000000000002,User outlyingLlama0: luscepited-000 might be true.
It's possible that PLACEHOLDER is true.,7,30,2,-23,0.21250000000000002,0.20475000000000002,User thrilledMare3: It's possible that luscepited-000 is true.
It is possibly true that PLACEHOLDER is true.,6,32,1,-26,0.175,0.20475000000000002,User murkyPiglet0: It is possibly true that luscepited-000 is true.
I'm unsure if PLACEHOLDER is true.,8,31,0,-23,0.21250000000000002,0.20475000000000002,User aboardEland3: I'm unsure if luscepited-000 is true.
It seems that PLACEHOLDER is true.,4,34,1,-30,0.125,0.20475000000000002,User sheepishFlamingo3: It seems that luscepited-000 is true.
I suspect PLACEHOLDER is true.,12,26,1,-14,0.325,0.20475000000000002,User sheepishChile6: I suspect luscepited-000 is true.
It seems that PLACEHOLDER is true.,4,34,1,-30,0.125,0.20475000000000002,User abjectRice0: It seems that luscepited-000 is true.
It could be that PLACEHOLDER is true.,5,33,1,-28,0.15000000000000002,0.20475000000000002,User lazyCheetah0: It could be that luscepited-000 is true.
It could be that PLACEHOLDER is true.,5,33,1,-28,0.15000000000000002,0.20475000000000002,User enragedCoconut0: It could be that luscepited-000 is true.
It's possible that PLACEHOLDER is true.,7,30,2,-23,0.21250000000000002,0.20475000000000002,User artisticCaribou4: It's possible that luscepited-000 is true.
I'm unsure if PLACEHOLDER is true.,8,31,0,-23,0.21250000000000002,0.20475000000000002,User cockyViper5: I'm unsure if luscepited-000 is true.
I believe PLACEHOLDER is true.,12,26,1,-14,0.325,0.20475000000000002,User hushedPoultry2: I believe luscepited-000 is true.
It's possible that PLACEHOLDER is true.,7,30,2,-23,0.21250000000000002,0.20475000000000002,User jumpyRuffs1: It's possible that luscepited-000 is true.
"Assuredly, PLACEHOLDER is true.",24,13,2,11,0.6375,0.20475000000000002,"User betrayedDove8: Assuredly, luscepited-000 is true."
I think PLACEHOLDER is true.,5,34,0,-29,0.1375,0.20475000000000002,User scornfulPorpoise6: I think luscepited-000 is true.
PLACEHOLDER might be true.,6,32,1,-26,0.175,0.20475000000000002,User exactingRuffs5: luscepited-000 might be true.
It's possible that PLACEHOLDER is true.,7,30,2,-23,0.21250000000000002,0.20275,User humorousMagpie3: It's possible that luscepited-001 is true.
It is possibly true that PLACEHOLDER is true.,6,32,1,-26,0.175,0.20275,User emptyGnu6: It is possibly true that luscepited-001 is true.
It is possibly true that PLACEHOLDER is true.,6,32,1,-26,0.175,0.20275,User peacefulSardines7: It is possibly true that luscepited-001 is true.
It is possibly true that PLACEHOLDER is true.,6,32,1,-26,0.175,0.20275,User drearyRhino2: It is possibly true that luscepited-001 is true.
PLACEHOLDER might be true.,6,32,1,-26,0.175,0.20275,User worldlyChile6: luscepited-001 might be true.
PLACEHOLDER might be true.,6,32,1,-26,0.175,0.20275,User pleasedCake9: luscepited-001 might be true.
It is possibly true that PLACEHOLDER is true.,6,32,1,-26,0.175,0.20275,User ecstaticLemur0: It is possibly true that luscepited-001 is true.
It seems that PLACEHOLDER is true.,4,34,1,-30,0.125,0.20275,User lazyBuzzard3: It seems that luscepited-001 is true.
PLACEHOLDER might be true.,6,32,1,-26,0.175,0.20275,User thrilledMoth4: luscepited-001 might be true.
I'd say PLACEHOLDER is true.,15,24,0,-9,0.3875,0.20275,User panickyCow7: I'd say luscepited-001 is true.
It could be that PLACEHOLDER is true.,5,33,1,-28,0.15000000000000002,0.20275,User ashamedKitten5: It could be that luscepited-001 is true.
I'm unsure if PLACEHOLDER is true.,8,31,0,-23,0.21250000000000002,0.20275,User contentQuiche4: I'm unsure if luscepited-001 is true.
Perhaps PLACEHOLDER is true.,3,35,1,-32,0.09999999999999998,0.20275,User excitedOatmeal7: Perhaps luscepited-001 is true.
PLACEHOLDER might be true.,6,32,1,-26,0.175,0.20275,User soreDoves7: luscepited-001 might be true.
I'm unsure if PLACEHOLDER is true.,8,31,0,-23,0.21250000000000002,0.20275,User dejectedToucan6: I'm unsure if luscepited-001 is true.
"Arguably, PLACEHOLDER is true.",11,28,0,-17,0.2875,0.20275,"User innocentMacaw1: Arguably, luscepited-001 is true."
It could be that PLACEHOLDER is true.,5,33,1,-28,0.15000000000000002,0.20275,User bubblyTacos7: It could be that luscepited-001 is true.
It is possibly true that PLACEHOLDER is true.,6,32,1,-26,0.175,0.20275,User betrayedAntelope0: It is possibly true that luscepited-001 is true.
It is possibly true that PLACEHOLDER is true.,6,32,1,-26,0.175,0.20275,User troubledTuna6: It is possibly true that luscepited-001 is true.
I'm unsure if PLACEHOLDER is true.,8,31,0,-23,0.21250000000000002,0.20275,User amazedCod5: I'm unsure if luscepited-001 is true.
I think PLACEHOLDER is true.,5,34,0,-29,0.1375,0.20275,User euphoricPolenta7: I think luscepited-001 is true.
I suspect PLACEHOLDER is true.,12,26,1,-14,0.325,0.20275,User gleefulHeron3: I suspect luscepited-001 is true.
It is possibly true that PLACEHOLDER is true.,6,32,1,-26,0.175,0.20275,User shyHeron2: It is possibly true that luscepited-001 is true.
It is possibly true that PLACEHOLDER is true.,6,32,1,-26,0.175,0.20275,User peskyCake9: It is possibly true that luscepited-001 is true.
It could be that PLACEHOLDER is true.,5,33,1,-28,0.15000000000000002,0.20275,User dejectedPudding5: It could be that luscepited-001 is true.
I'm unsure if PLACEHOLDER is true.,8,31,0,-23,0.21250000000000002,0.20275,User excludedCow4: I'm unsure if luscepited-001 is true.
There is a chance that PLACEHOLDER is true.,2,37,0,-35,0.0625,0.20275,User truthfulOcelot7: There is a chance that luscepited-001 is true.
PLACEHOLDER might be true.,6,32,1,-26,0.175,0.20275,User bubblySeafowl3: luscepited-001 might be true.
It's possible that PLACEHOLDER is true.,7,30,2,-23,0.21250000000000002,0.20275,User boredFalcon8: It's possible that luscepited-001 is true.
It is possibly true that PLACEHOLDER is true.,6,32,1,-26,0.175,0.20275,User sadTeal4: It is possibly true that luscepited-001 is true.
PLACEHOLDER might be true.,6,32,1,-26,0.175,0.20275,User worriedWildfowl2: luscepited-001 might be true.
It's possible that PLACEHOLDER is true.,7,30,2,-23,0.21250000000000002,0.20275,User vengefulWigeon9: It's possible that luscepited-001 is true.
I'm unsure if PLACEHOLDER is true.,8,31,0,-23,0.21250000000000002,0.20275,User tautJerky6: I'm unsure if luscepited-001 is true.
I'm unsure if PLACEHOLDER is true.,8,31,0,-23,0.21250000000000002,0.20275,User crushedLemur8: I'm unsure if luscepited-001 is true.
I'm unsure if PLACEHOLDER is true.,8,31,0,-23,0.21250000000000002,0.20275,User decimalViper2: I'm unsure if luscepited-001 is true.
It is probably true that PLACEHOLDER is true.,16,19,4,-3,0.4625,0.20275,User peacefulTuna9: It is probably true that luscepited-001 is true.
It is possibly true that PLACEHOLDER is true.,6,32,1,-26,0.175,0.20275,User lazyBurritos3: It is possibly true that luscepited-001 is true.
It seems that PLACEHOLDER is true.,4,34,1,-30,0.125,0.20275,User humorousCheese5: It seems that luscepited-001 is true.
I'm unsure if PLACEHOLDER is true.,8,31,0,-23,0.21250000000000002,0.20275,User artisticLollies7: I'm unsure if luscepited-001 is true.
I'm unsure if PLACEHOLDER is true.,8,31,0,-23,0.21250000000000002,0.20275,User amusedHoopoe5: I'm unsure if luscepited-001 is true.
PLACEHOLDER might be true.,6,32,1,-26,0.175,0.20275,User enragedLollies1: luscepited-001 might be true.
PLACEHOLDER might be true.,6,32,1,-26,0.175,0.20275,User morbidChough0: luscepited-001 might be true.
I'm unsure if PLACEHOLDER is true.,8,31,0,-23,0.21250000000000002,0.20275,User artisticTuna3: I'm unsure if luscepited-001 is true.
I'm unsure if PLACEHOLDER is true.,8,31,0,-23,0.21250000000000002,0.20275,User brainyHare2: I'm unsure if luscepited-001 is true.
I'm unsure if PLACEHOLDER is true.,8,31,0,-23,0.21250000000000002,0.20275,User thrilledDingo5: I'm unsure if luscepited-001 is true.
It could be that PLACEHOLDER is true.,5,33,1,-28,0.15000000000000002,0.20275,User similarOil3: It could be that luscepited-001 is true.
It could be that PLACEHOLDER is true.,5,33,1,-28,0.15000000000000002,0.20275,User empathicTermite5: It could be that luscepited-001 is true.
It is probably true that PLACEHOLDER is true.,16,19,4,-3,0.4625,0.20275,User gleefulLapwing0: It is probably true that luscepited-001 is true.
It's likely that PLACEHOLDER is true.,15,23,1,-8,0.4,0.20275,User drearyWigeon6: It's likely that luscepited-001 is true.
It is possibly true that PLACEHOLDER is true.,6,32,1,-26,0.175,0.20275,User grudgingVenison3: It is possibly true that luscepited-001 is true.
It is possibly true that PLACEHOLDER is true.,6,32,1,-26,0.175,0.20375,User crummyLizard6: It is possibly true that luscepited-002 is true.
I'm unsure if PLACEHOLDER is true.,8,31,0,-23,0.21250000000000002,0.20375,User thrilledSeagull0: I'm unsure if luscepited-002 is true.
I think PLACEHOLDER is true.,5,34,0,-29,0.1375,0.20375,User forsakenCordial3: I think luscepited-002 is true.
I'm unsure if PLACEHOLDER is true.,8,31,0,-23,0.21250000000000002,0.20375,User brainySausage1: I'm unsure if luscepited-002 is true.
PLACEHOLDER might be true.,6,32,1,-26,0.175,0.20375,User excitedOcelot0: luscepited-002 might be true.
I'm unsure if PLACEHOLDER is true.,8,31,0,-23,0.21250000000000002,0.20375,User unhappyTeal4: I'm unsure if luscepited-002 is true.
PLACEHOLDER might be true.,6,32,1,-26,0.175,0.20375,User curiousGnu1: luscepited-002 might be true.
I'm unsure if PLACEHOLDER is true.,8,31,0,-23,0.21250000000000002,0.20375,User pleasedWildfowl7: I'm unsure if luscepited-002 is true.
It's possible that PLACEHOLDER is true.,7,30,2,-23,0.21250000000000002,0.20375,User worriedSeahorse0: It's possible that luscepited-002 is true.
"From what I can tell, PLACEHOLDER is true.",22,16,1,6,0.575,0.20375,"User wornoutPorpoise5: From what I can tell, luscepited-002 is true."
It could be that PLACEHOLDER is true.,5,33,1,-28,0.15000000000000002,0.20375,User resolvedChowder4: It could be that luscepited-002 is true.
I'm unsure if PLACEHOLDER is true.,8,31,0,-23,0.21250000000000002,0.20375,User sugaryBass5: I'm unsure if luscepited-002 is true.
It appears that PLACEHOLDER is true.,11,27,1,-16,0.3,0.20375,User spiritedCordial5: It appears that luscepited-002 is true.
It's possible that PLACEHOLDER is true.,7,30,2,-23,0.21250000000000002,0.20375,User peskyWildfowl1: It's possible that luscepited-002 is true.
It is clear that PLACEHOLDER is true.,17,20,2,-3,0.4625,0.20375,User decimalOtter0: It is clear that luscepited-002 is true.
I'm unsure if PLACEHOLDER is true.,8,31,0,-23,0.21250000000000002,0.20375,User worldlySeagull4: I'm unsure if luscepited-002 is true.
PLACEHOLDER might be true.,6,32,1,-26,0.175,0.20375,User needySalami9: luscepited-002 might be true.
It seems that PLACEHOLDER is true.,4,34,1,-30,0.125,0.20375,User similarWeaver2: It seems that luscepited-002 is true.
It is possibly true that PLACEHOLDER is true.,6,32,1,-26,0.175,0.20375,User vengefulOrange0: It is possibly true that luscepited-002 is true.
It's possible that PLACEHOLDER is true.,7,30,2,-23,0.21250000000000002,0.20375,User amazedOrange1: It's possible that luscepited-002 is true.
I'm unsure if PLACEHOLDER is true.,8,31,0,-23,0.21250000000000002,0.20375,User ecstaticRhino7: I'm unsure if luscepited-002 is true.
It appears that PLACEHOLDER is true.,11,27,1,-16,0.3,0.20375,User artisticStork8: It appears that luscepited-002 is true.
There is a chance that PLACEHOLDER is true.,2,37,0,-35,0.0625,0.20375,User sadOtter0: There is a chance that luscepited-002 is true.
It's possible that PLACEHOLDER is true.,7,30,2,-23,0.21250000000000002,0.20375,User soreFerret7: It's possible that luscepited-002 is true.
PLACEHOLDER might be true.,6,32,1,-26,0.175,0.20375,User contentPonie4: luscepited-002 might be true.
It's possible that PLACEHOLDER is true.,7,30,2,-23,0.21250000000000002,0.20375,User wrathfulToucan9: It's possible that luscepited-002 is true.
It is possibly true that PLACEHOLDER is true.,6,32,1,-26,0.175,0.20375,User eagerRuffs7: It is possibly true that luscepited-002 is true.
PLACEHOLDER might be true.,6,32,1,-26,0.175,0.20375,User boredKitten5: luscepited-002 might be true.
It is possibly true that PLACEHOLDER is true.,6,32,1,-26,0.175,0.20375,User thrilledShads0: It is possibly true that luscepited-002 is true.
I'm unsure if PLACEHOLDER is true.,8,31,0,-23,0.21250000000000002,0.20375,User scornfulPonie0: I'm unsure if luscepited-002 is true.
I think PLACEHOLDER is true.,5,34,0,-29,0.1375,0.20375,User shamefulTomatoe4: I think luscepited-002 is true.
I'm unsure if PLACEHOLDER is true.,8,31,0,-23,0.21250000000000002,0.20375,User betrayedIcecream0: I'm unsure if luscepited-002 is true.
PLACEHOLDER might be true.,6,32,1,-26,0.175,0.20375,User sadTermite8: luscepited-002 might be true.
I'm unsure if PLACEHOLDER is true.,8,31,0,-23,0.21250000000000002,0.20375,User eagerSalami6: I'm unsure if luscepited-002 is true.
PLACEHOLDER might be true.,6,32,1,-26,0.175,0.20375,User mellowBuzzard4: luscepited-002 might be true.
I'm unsure if PLACEHOLDER is true.,8,31,0,-23,0.21250000000000002,0.20375,User dearCake3: I'm unsure if luscepited-002 is true.
Perhaps PLACEHOLDER is true.,3,35,1,-32,0.09999999999999998,0.20375,User pacifiedAbalone7: Perhaps luscepited-002 is true.
It is possibly true that PLACEHOLDER is true.,6,32,1,-26,0.175,0.20375,User wingedQuiche4: It is possibly true that luscepited-002 is true.
PLACEHOLDER might be true.,6,32,1,-26,0.175,0.20375,User stressedSalt5: luscepited-002 might be true.
It seems that PLACEHOLDER is true.,4,34,1,-30,0.125,0.20375,User lazyHare6: It seems that luscepited-002 is true.
I suspect PLACEHOLDER is true.,12,26,1,-14,0.325,0.20375,User pacifiedRelish9: I suspect luscepited-002 is true.
It's possible that PLACEHOLDER is true.,7,30,2,-23,0.21250000000000002,0.20375,User dreadfulSheep8: It's possible that luscepited-002 is true.
I'm unsure if PLACEHOLDER is true.,8,31,0,-23,0.21250000000000002,0.20375,User gleefulMeerkat7: I'm unsure if luscepited-002 is true.
It's possible that PLACEHOLDER is true.,7,30,2,-23,0.21250000000000002,0.20375,User empathicSausage0: It's possible that luscepited-002 is true.
It is possibly true that PLACEHOLDER is true.,6,32,1,-26,0.175,0.20375,User dreadfulZebra0: It is possibly true that luscepited-002 is true.
It seems that PLACEHOLDER is true.,4,34,1,-30,0.125,0.20375,User grizzledStork1: It seems that luscepited-002 is true.
PLACEHOLDER might be true.,6,32,1,-26,0.175,0.20375,User unhappyFerret5: luscepited-002 might be true.
It is possibly true that PLACEHOLDER is true.,6,32,1,-26,0.175,0.20375,User murkyCrackers4: It is possibly true that luscepited-002 is true.
I'm unsure if PLACEHOLDER is true.,8,31,0,-23,0.21250000000000002,0.20375,User troubledFish6: I'm unsure if luscepited-002 is true.
I'm unsure if PLACEHOLDER is true.,8,31,0,-23,0.21250000000000002,0.20375,User goofyLollies6: I'm unsure if luscepited-002 is true.
It is possibly true that PLACEHOLDER is true.,6,32,1,-26,0.175,0.20425000000000004,User zestyBasmati7: It is possibly true that luscepited-003 is true.
I believe PLACEHOLDER is true.,12,26,1,-14,0.325,0.20425000000000004,User lovesickTeal8: I believe luscepited-003 is true.
I believe PLACEHOLDER is true.,12,26,1,-14,0.325,0.20425000000000004,User madHyena7: I believe luscepited-003 is true.
I'm unsure if PLACEHOLDER is true.,8,31,0,-23,0.21250000000000002,0.20425000000000004,User outlyingLlama9: I'm unsure if luscepited-003 is true.
It is possibly true that PLACEHOLDER is true.,6,32,1,-26,0.175,0.20425000000000004,User aboardDingo1: It is possibly true that luscepited-003 is true.
It's possible that PLACEHOLDER is true.,7,30,2,-23,0.21250000000000002,0.20425000000000004,User chicPolenta7: It's possible that luscepited-003 is true.
It's possible that PLACEHOLDER is true.,7,30,2,-23,0.21250000000000002,0.20425000000000004,User adoringPorpoise7: It's possible that luscepited-003 is true.
It could be that PLACEHOLDER is true.,5,33,1,-28,0.15000000000000002,0.20425000000000004,User yearningOil6: It could be that luscepited-003 is true.
It's possible that PLACEHOLDER is true.,7,30,2,-23,0.21250000000000002,0.20425000000000004,User excludedDotterel0: It's possible that luscepited-003 is true.
I think PLACEHOLDER is true.,5,34,0,-29,0.1375,0.20425000000000004,User worldlyStork9: I think luscepited-003 is true.
It's possible that PLACEHOLDER is true.,7,30,2,-23,0.21250000000000002,0.20425000000000004,User dopeySnail4: It's possible that luscepited-003 is true.
It is possibly true that PLACEHOLDER is true.,6,32,1,-26,0.175,0.20425000000000004,User jubilantCrane4: It is possibly true that luscepited-003 is true.
It's possible that PLACEHOLDER is true.,7,30,2,-23,0.21250000000000002,0.20425000000000004,User awedDunbird0: It's possible that luscepited-003 is true.
"Arguably, PLACEHOLDER is true.",11,28,0,-17,0.2875,0.20425000000000004,"User importedPie8: Arguably, luscepited-003 is true."
I think PLACEHOLDER is true.,5,34,0,-29,0.1375,0.20425000000000004,User sincereCurlew5: I think luscepited-003 is true.
It could be that PLACEHOLDER is true.,5,33,1,-28,0.15000000000000002,0.20425000000000004,User worldlyTomatoe7: It could be that luscepited-003 is true.
It's possible that PLACEHOLDER is true.,7,30,2,-23,0.21250000000000002,0.20425000000000004,User empathicPoultry1: It's possible that luscepited-003 is true.
PLACEHOLDER might be true.,6,32,1,-26,0.175,0.20425000000000004,User pleasedCaviar3: luscepited-003 might be true.
"Arguably, PLACEHOLDER is true.",11,28,0,-17,0.2875,0.20425000000000004,"User grumpyVenison3: Arguably, luscepited-003 is true."
It's possible that PLACEHOLDER is true.,7,30,2,-23,0.21250000000000002,0.20425000000000004,User betrayedAntelope5: It's possible that luscepited-003 is true.
It is possibly true that PLACEHOLDER is true.,6,32,1,-26,0.175,0.20425000000000004,User guiltyShads6: It is possibly true that luscepited-003 is true.
It seems that PLACEHOLDER is true.,4,34,1,-30,0.125,0.20425000000000004,User pluckyEggs5: It seems that luscepited-003 is true.
"If I had to guess,I'd say PLACEHOLDER is true.",17,22,0,-5,0.4375,0.20425000000000004,"User amusedRelish9: If I had to guess,I'd say luscepited-003 is true."
Perhaps PLACEHOLDER is true.,3,35,1,-32,0.09999999999999998,0.20425000000000004,User thriftyPup6: Perhaps luscepited-003 is true.
PLACEHOLDER might be true.,6,32,1,-26,0.175,0.20425000000000004,User sadOtter1: luscepited-003 might be true.
It seems that PLACEHOLDER is true.,4,34,1,-30,0.125,0.20425000000000004,User shamefulGranola8: It seems that luscepited-003 is true.
I think PLACEHOLDER is true.,5,34,0,-29,0.1375,0.20425000000000004,User needyLemur5: I think luscepited-003 is true.
I assume PLACEHOLDER is true.,14,25,0,-11,0.3625,0.20425000000000004,User giddyStork0: I assume luscepited-003 is true.
It seems that PLACEHOLDER is true.,4,34,1,-30,0.125,0.20425000000000004,User abjectTermite1: It seems that luscepited-003 is true.
It is possibly true that PLACEHOLDER is true.,6,32,1,-26,0.175,0.20425000000000004,User sincerePonie4: It is possibly true that luscepited-003 is true.
Perhaps PLACEHOLDER is true.,3,35,1,-32,0.09999999999999998,0.20425000000000004,User guiltyThrush0: Perhaps luscepited-003 is true.
It seems that PLACEHOLDER is true.,4,34,1,-30,0.125,0.20425000000000004,User unhappyLion6: It seems that luscepited-003 is true.
It's possible that PLACEHOLDER is true.,7,30,2,-23,0.21250000000000002,0.20425000000000004,User euphoricApricots6: It's possible that luscepited-003 is true.
"If I had to guess,I'd say PLACEHOLDER is true.",17,22,0,-5,0.4375,0.20425000000000004,"User sincereHare2: If I had to guess,I'd say luscepited-003 is true."
It's possible that PLACEHOLDER is true.,7,30,2,-23,0.21250000000000002,0.20425000000000004,User similarSheep1: It's possible that luscepited-003 is true.
I'm unsure if PLACEHOLDER is true.,8,31,0,-23,0.21250000000000002,0.20425000000000004,User ecstaticWeaver4: I'm unsure if luscepited-003 is true.
PLACEHOLDER might be true.,6,32,1,-26,0.175,0.20425000000000004,User wearyPudding2: luscepited-003 might be true.
"Arguably, PLACEHOLDER is true.",11,28,0,-17,0.2875,0.20425000000000004,"User grizzledRuffs6: Arguably, luscepited-003 is true."
It seems that PLACEHOLDER is true.,4,34,1,-30,0.125,0.20425000000000004,User debonairApples7: It seems that luscepited-003 is true.
I think PLACEHOLDER is true.,5,34,0,-29,0.1375,0.20425000000000004,User excludedCoati3: I think luscepited-003 is true.
PLACEHOLDER might be true.,6,32,1,-26,0.175,0.20425000000000004,User thriftyLeopard8: luscepited-003 might be true.
It is possibly true that PLACEHOLDER is true.,6,32,1,-26,0.175,0.20425000000000004,User exactingTomatoe9: It is possibly true that luscepited-003 is true.
I'm unsure if PLACEHOLDER is true.,8,31,0,-23,0.21250000000000002,0.20425000000000004,User boredBuck8: I'm unsure if luscepited-003 is true.
Chances are PLACEHOLDER is true.,12,27,0,-15,0.3125,0.20425000000000004,User affectedHawk7: Chances are luscepited-003 is true.
I think PLACEHOLDER is true.,5,34,0,-29,0.1375,0.20425000000000004,User resolvedRhino9: I think luscepited-003 is true.
It is possibly true that PLACEHOLDER is true.,6,32,1,-26,0.175,0.20425000000000004,User debonairDingo2: It is possibly true that luscepited-003 is true.
"Arguably, PLACEHOLDER is true.",11,28,0,-17,0.2875,0.20425000000000004,"User betrayedMuesli3: Arguably, luscepited-003 is true."
It's possible that PLACEHOLDER is true.,7,30,2,-23,0.21250000000000002,0.20425000000000004,User solidWigeon3: It's possible that luscepited-003 is true.
I'm unsure if PLACEHOLDER is true.,8,31,0,-23,0.21250000000000002,0.20425000000000004,User debonairAntelope8: I'm unsure if luscepited-003 is true.
It could be that PLACEHOLDER is true.,5,33,1,-28,0.15000000000000002,0.20425000000000004,User guiltyClam6: It could be that luscepited-003 is true.
It's possible that PLACEHOLDER is true.,7,30,2,-23,0.21250000000000002,0.20250000000000004,User madBass0: It's possible that luscepited-004 is true.
I'm unsure if PLACEHOLDER is true.,8,31,0,-23,0.21250000000000002,0.20250000000000004,User boredMeerkat1: I'm unsure if luscepited-004 is true.
I'm unsure if PLACEHOLDER is true.,8,31,0,-23,0.21250000000000002,0.20250000000000004,User abjectCur4: I'm unsure if luscepited-004 is true.
I think PLACEHOLDER is true.,5,34,0,-29,0.1375,0.20250000000000004,User excitedTacos5: I think luscepited-004 is true.
It appears that PLACEHOLDER is true.,11,27,1,-16,0.3,0.20250000000000004,User boredBasmati8: It appears that luscepited-004 is true.
It is possibly true that PLACEHOLDER is true.,6,32,1,-26,0.175,0.20250000000000004,User enviousBaboon4: It is possibly true that luscepited-004 is true.
I'm unsure if PLACEHOLDER is true.,8,31,0,-23,0.21250000000000002,0.20250000000000004,User needyIguana8: I'm unsure if luscepited-004 is true.
It could be that PLACEHOLDER is true.,5,33,1,-28,0.15000000000000002,0.20250000000000004,User dopeyMallard6: It could be that luscepited-004 is true.
It is possibly true that PLACEHOLDER is true.,6,32,1,-26,0.175,0.20250000000000004,User scornfulPudding7: It is possibly true that luscepited-004 is true.
Chances are PLACEHOLDER is true.,12,27,0,-15,0.3125,0.20250000000000004,User enragedTeal9: Chances are luscepited-004 is true.
It is possibly true that PLACEHOLDER is true.,6,32,1,-26,0.175,0.20250000000000004,User cynicalPolenta3: It is possibly true that luscepited-004 is true.
I'm unsure if PLACEHOLDER is true.,8,31,0,-23,0.21250000000000002,0.20250000000000004,User betrayedChough0: I'm unsure if luscepited-004 is true.
There is a chance that PLACEHOLDER is true.,2,37,0,-35,0.0625,0.20250000000000004,User drearyOryx1: There is a chance that luscepited-004 is true.
"Arguably, PLACEHOLDER is true.",11,28,0,-17,0.2875,0.20250000000000004,"User aloofPepper2: Arguably, luscepited-004 is true."
It is possibly true that PLACEHOLDER is true.,6,32,1,-26,0.175,0.20250000000000004,User joyfulMallard3: It is possibly true that luscepited-004 is true.
I'm unsure if PLACEHOLDER is true.,8,31,0,-23,0.21250000000000002,0.20250000000000004,User awedFlamingo8: I'm unsure if luscepited-004 is true.
It seems that PLACEHOLDER is true.,4,34,1,-30,0.125,0.20250000000000004,User thrilledSardines9: It seems that luscepited-004 is true.
It seems that PLACEHOLDER is true.,4,34,1,-30,0.125,0.20250000000000004,User eagerDove6: It seems that luscepited-004 is true.
I assume PLACEHOLDER is true.,14,25,0,-11,0.3625,0.20250000000000004,User joyfulThrushe4: I assume luscepited-004 is true.
It is possibly true that PLACEHOLDER is true.,6,32,1,-26,0.175,0.20250000000000004,User morbidSalt1: It is possibly true that luscepited-004 is true.
It appears that PLACEHOLDER is true.,11,27,1,-16,0.3,0.20250000000000004,User peskyCoati3: It appears that luscepited-004 is true.
PLACEHOLDER might be true.,6,32,1,-26,0.175,0.20250000000000004,User mereTeal3: luscepited-004 might be true.
It could be that PLACEHOLDER is true.,5,33,1,-28,0.15000000000000002,0.20250000000000004,User crummyLemur9: It could be that luscepited-004 is true.
It is possibly true that PLACEHOLDER is true.,6,32,1,-26,0.175,0.20250000000000004,User boastfulThrushe4: It is possibly true that luscepited-004 is true.
I assume PLACEHOLDER is true.,14,25,0,-11,0.3625,0.20250000000000004,User trustingOtter5: I assume luscepited-004 is true.
It could be that PLACEHOLDER is true.,5,33,1,-28,0.15000000000000002,0.20250000000000004,User dearDunbird4: It could be that luscepited-004 is true.
It's possible that PLACEHOLDER is true.,7,30,2,-23,0.21250000000000002,0.20250000000000004,User pacifiedStork8: It's possible that luscepited-004 is true.
PLACEHOLDER might be true.,6,32,1,-26,0.175,0.20250000000000004,User blissfulEland0: luscepited-004 might be true.
"To the best of my knowledge, PLACEHOLDER is true.",23,16,0,7,0.5875,0.20250000000000004,"User cockySeafowl7: To the best of my knowledge, luscepited-004 is true."
It is possibly true that PLACEHOLDER is true.,6,32,1,-26,0.175,0.20250000000000004,User brainyKitten0: It is possibly true that luscepited-004 is true.
PLACEHOLDER might be true.,6,32,1,-26,0.175,0.20250000000000004,User sincereBaboon4: luscepited-004 might be true.
It's possible that PLACEHOLDER is true.,7,30,2,-23,0.21250000000000002,0.20250000000000004,User soreBobolink6: It's possible that luscepited-004 is true.
It is possibly true that PLACEHOLDER is true.,6,32,1,-26,0.175,0.20250000000000004,User grudgingMackerel9: It is possibly true that luscepited-004 is true.
I'm unsure if PLACEHOLDER is true.,8,31,0,-23,0.21250000000000002,0.20250000000000004,User mereBuck6: I'm unsure if luscepited-004 is true.
It could be that PLACEHOLDER is true.,5,33,1,-28,0.15000000000000002,0.20250000000000004,User grizzledPudding7: It could be that luscepited-004 is true.
It's possible that PLACEHOLDER is true.,7,30,2,-23,0.21250000000000002,0.20250000000000004,User sincerePepper1: It's possible that luscepited-004 is true.
It seems that PLACEHOLDER is true.,4,34,1,-30,0.125,0.20250000000000004,User emptyOryx4: It seems that luscepited-004 is true.
PLACEHOLDER might be true.,6,32,1,-26,0.175,0.20250000000000004,User grudgingZebra2: luscepited-004 might be true.
PLACEHOLDER might be true.,6,32,1,-26,0.175,0.20250000000000004,User pacifiedBurritos4: luscepited-004 might be true.
Perhaps PLACEHOLDER is true.,3,35,1,-32,0.09999999999999998,0.20250000000000004,User mellowOil5: Perhaps luscepited-004 is true.
Perhaps PLACEHOLDER is true.,3,35,1,-32,0.09999999999999998,0.20250000000000004,User sheepishBass2: Perhaps luscepited-004 is true.
PLACEHOLDER might be true.,6,32,1,-26,0.175,0.20250000000000004,User unhappySyrup6: luscepited-004 might be true.
It's possible that PLACEHOLDER is true.,7,30,2,-23,0.21250000000000002,0.20250000000000004,User annoyedCockatoo2: It's possible that luscepited-004 is true.
It's possible that PLACEHOLDER is true.,7,30,2,-23,0.21250000000000002,0.20250000000000004,User panickyDoves2: It's possible that luscepited-004 is true.
It's possible that PLACEHOLDER is true.,7,30,2,-23,0.21250000000000002,0.20250000000000004,User eagerSalami1: It's possible that luscepited-004 is true.
I'm unsure if PLACEHOLDER is true.,8,31,0,-23,0.21250000000000002,0.20250000000000004,User yearningOtter8: I'm unsure if luscepited-004 is true.
I'm unsure if PLACEHOLDER is true.,8,31,0,-23,0.21250000000000002,0.20250000000000004,User pridefulPolenta7: I'm unsure if luscepited-004 is true.
I'm unsure if PLACEHOLDER is true.,8,31,0,-23,0.21250000000000002,0.20250000000000004,User contentEland3: I'm unsure if luscepited-004 is true.
PLACEHOLDER might be true.,6,32,1,-26,0.175,0.20250000000000004,User betrayedSmelt7: luscepited-004 might be true.
I'm unsure if PLACEHOLDER is true.,8,31,0,-23,0.21250000000000002,0.20250000000000004,User pleasedBaboon6: I'm unsure if luscepited-004 is true.
I'd say PLACEHOLDER is true.,15,24,0,-9,0.3875,0.35,User puzzledLlama3: I'd say calhams-000 is true.
I assume PLACEHOLDER is true.,14,25,0,-11,0.3625,0.35,User emptyEland2: I assume calhams-000 is true.
"Arguably, PLACEHOLDER is true.",11,28,0,-17,0.2875,0.35,"User grudgingOil7: Arguably, calhams-000 is true."
There is a chance that PLACEHOLDER is true.,2,37,0,-35,0.0625,0.35,User murkyStork4: There is a chance that calhams-000 is true.
I'd say PLACEHOLDER is true.,15,24,0,-9,0.3875,0.35,User abjectBittern2: I'd say calhams-000 is true.
I assume PLACEHOLDER is true.,14,25,0,-11,0.3625,0.35,User chicBaboon6: I assume calhams-000 is true.
It's likely that PLACEHOLDER is true.,15,23,1,-8,0.4,0.35,User forsakenTacos4: It's likely that calhams-000 is true.
"If I had to guess,I'd say PLACEHOLDER is true.",17,22,0,-5,0.4375,0.35,"User tautOcelot9: If I had to guess,I'd say calhams-000 is true."
PLACEHOLDER might be true.,6,32,1,-26,0.175,0.35,User pridefulToucan6: calhams-000 might be true.
It is possibly true that PLACEHOLDER is true.,6,32,1,-26,0.175,0.35,User panickyFerret3: It is possibly true that calhams-000 is true.
I assume PLACEHOLDER is true.,14,25,0,-11,0.3625,0.35,User ecstaticCrane1: I assume calhams-000 is true.
I'd say PLACEHOLDER is true.,15,24,0,-9,0.3875,0.35,User madToucan2: I'd say calhams-000 is true.
I assume PLACEHOLDER is true.,14,25,0,-11,0.3625,0.35,User forsakenMoth5: I assume calhams-000 is true.
"Arguably, PLACEHOLDER is true.",11,28,0,-17,0.2875,0.35,"User decimalCaribou6: Arguably, calhams-000 is true."
I assume PLACEHOLDER is true.,14,25,0,-11,0.3625,0.35,User pluckyRice6: I assume calhams-000 is true.
I believe PLACEHOLDER is true.,12,26,1,-14,0.325,0.35,User sincereTeal0: I believe calhams-000 is true.
I assume PLACEHOLDER is true.,14,25,0,-11,0.3625,0.35,User grizzledMandrill8: I assume calhams-000 is true.
It is clear that PLACEHOLDER is true.,17,20,2,-3,0.4625,0.35,User jumpyRhino2: It is clear that calhams-000 is true.
Chances are PLACEHOLDER is true.,12,27,0,-15,0.3125,0.35,User bubblyKitten6: Chances are calhams-000 is true.
I suspect PLACEHOLDER is true.,12,26,1,-14,0.325,0.35,User unhappyThrush8: I suspect calhams-000 is true.
I assume PLACEHOLDER is true.,14,25,0,-11,0.3625,0.35,User superiorTruffle7: I assume calhams-000 is true.
I'd say PLACEHOLDER is true.,15,24,0,-9,0.3875,0.35,User humorousVenison5: I'd say calhams-000 is true.
I assume PLACEHOLDER is true.,14,25,0,-11,0.3625,0.35,User giddyJerky9: I assume calhams-000 is true.
It's likely that PLACEHOLDER is true.,15,23,1,-8,0.4,0.35,User superiorBuck3: It's likely that calhams-000 is true.
I'd say PLACEHOLDER is true.,15,24,0,-9,0.3875,0.35,User humorousCheetah7: I'd say calhams-000 is true.
I'd say PLACEHOLDER is true.,15,24,0,-9,0.3875,0.35,User superiorLizard8: I'd say calhams-000 is true.
It is possibly true that PLACEHOLDER is true.,6,32,1,-26,0.175,0.35,User amazedGnu5: It is possibly true that calhams-000 is true.
I assume PLACEHOLDER is true.,14,25,0,-11,0.3625,0.35,User aloofGelding7: I assume calhams-000 is true.
I suspect PLACEHOLDER is true.,12,26,1,-14,0.325,0.35,User amazedFish2: I suspect calhams-000 is true.
I assume PLACEHOLDER is true.,14,25,0,-11,0.3625,0.35,User sheepishOatmeal7: I assume calhams-000 is true.
I believe PLACEHOLDER is true.,12,26,1,-14,0.325,0.35,User ecstaticSnail7: I believe calhams-000 is true.
I suspect PLACEHOLDER is true.,12,26,1,-14,0.325,0.35,User morbidFerret1: I suspect calhams-000 is true.
I'd say PLACEHOLDER is true.,15,24,0,-9,0.3875,0.35,User dopeyPoultry2: I'd say calhams-000 is true.
I'd say PLACEHOLDER is true.,15,24,0,-9,0.3875,0.35,User ashamedSnail7: I'd say calhams-000 is true.
It appears that PLACEHOLDER is true.,11,27,1,-16,0.3,0.35,User dopeyApricots0: It appears that calhams-000 is true.
Chances are PLACEHOLDER is true.,12,27,0,-15,0.3125,0.35,User puzzledDove9: Chances are calhams-000 is true.
Perhaps PLACEHOLDER is true.,3,35,1,-32,0.09999999999999998,0.35,User affectedSeagull1: Perhaps calhams-000 is true.
It's likely that PLACEHOLDER is true.,15,23,1,-8,0.4,0.35,User decimalUnicorn8: It's likely that calhams-000 is true.
It's likely that PLACEHOLDER is true.,15,23,1,-8,0.4,0.35,User ashamedPorpoise7: It's likely that calhams-000 is true.
I believe PLACEHOLDER is true.,12,26,1,-14,0.325,0.35,User affectedBass6: I believe calhams-000 is true.
There's no question about it; PLACEHOLDER is true.,27,8,4,19,0.7375,0.35,User culturedPie3: There's no question about it; calhams-000 is true.
I believe PLACEHOLDER is true.,12,26,1,-14,0.325,0.35,User offendedAbalone5: I believe calhams-000 is true.
I believe PLACEHOLDER is true.,12,26,1,-14,0.325,0.35,User debonairBaboon9: I believe calhams-000 is true.
I suspect PLACEHOLDER is true.,12,26,1,-14,0.325,0.35,User jubilantMacaw9: I suspect calhams-000 is true.
It is clear that PLACEHOLDER is true.,17,20,2,-3,0.4625,0.35,User truthfulGelding5: It is clear that calhams-000 is true.
It's likely that PLACEHOLDER is true.,15,23,1,-8,0.4,0.35,User guiltyPolenta2: It's likely that calhams-000 is true.
"Arguably, PLACEHOLDER is true.",11,28,0,-17,0.2875,0.35,"User morbidBoars7: Arguably, calhams-000 is true."
"To the best of my knowledge, PLACEHOLDER is true.",23,16,0,7,0.5875,0.35,"User boastfulLemur0: To the best of my knowledge, calhams-000 is true."
I assume PLACEHOLDER is true.,14,25,0,-11,0.3625,0.35,User jumpyWhiting3: I assume calhams-000 is true.
I believe PLACEHOLDER is true.,12,26,1,-14,0.325,0.35,User ardentPlover7: I believe calhams-000 is true.
I'm quite certain that PLACEHOLDER is true.,31,8,0,23,0.7875,0.35324999999999995,User superiorFalcon8: I'm quite certain that calhams-001 is true.
I'm sure that PLACEHOLDER is true.,27,10,2,17,0.7125,0.35324999999999995,User mercifulCaviar5: I'm sure that calhams-001 is true.
It is clear that PLACEHOLDER is true.,17,20,2,-3,0.4625,0.35324999999999995,User excitedBurritos3: It is clear that calhams-001 is true.
I'd say PLACEHOLDER is true.,15,24,0,-9,0.3875,0.35324999999999995,User outlyingPlover9: I'd say calhams-001 is true.
I'd say PLACEHOLDER is true.,15,24,0,-9,0.3875,0.35324999999999995,User crushedRelish3: I'd say calhams-001 is true.
I suspect PLACEHOLDER is true.,12,26,1,-14,0.325,0.35324999999999995,User madDoves7: I suspect calhams-001 is true.
I'd say PLACEHOLDER is true.,15,24,0,-9,0.3875,0.35324999999999995,User grudgingPiglet3: I'd say calhams-001 is true.
I assume PLACEHOLDER is true.,14,25,0,-11,0.3625,0.35324999999999995,User chicMallard5: I assume calhams-001 is true.
I suspect PLACEHOLDER is true.,12,26,1,-14,0.325,0.35324999999999995,User ferventWigeon5: I suspect calhams-001 is true.
I suspect PLACEHOLDER is true.,12,26,1,-14,0.325,0.35324999999999995,User ferventGelding3: I suspect calhams-001 is true.
I believe PLACEHOLDER is true.,12,26,1,-14,0.325,0.35324999999999995,User wingedPoultry2: I believe calhams-001 is true.
It is probably true that PLACEHOLDER is true.,16,19,4,-3,0.4625,0.35324999999999995,User wingedCurlew0: It is probably true that calhams-001 is true.
I assume PLACEHOLDER is true.,14,25,0,-11,0.3625,0.35324999999999995,User needfulRelish7: I assume calhams-001 is true.
It's likely that PLACEHOLDER is true.,15,23,1,-8,0.4,0.35324999999999995,User guiltyCake9: It's likely that calhams-001 is true.
I assume PLACEHOLDER is true.,14,25,0,-11,0.3625,0.35324999999999995,User cheerfulMandrill2: I assume calhams-001 is true.
I believe PLACEHOLDER is true.,12,26,1,-14,0.325,0.35324999999999995,User cheerfulBagels8: I believe calhams-001 is true.
I assume PLACEHOLDER is true.,14,25,0,-11,0.3625,0.35324999999999995,User holisticSnipe2: I assume calhams-001 is true.
"Arguably, PLACEHOLDER is true.",11,28,0,-17,0.2875,0.35324999999999995,"User fondMagpie3: Arguably, calhams-001 is true."
Chances are PLACEHOLDER is true.,12,27,0,-15,0.3125,0.35324999999999995,User worldlyTeal0: Chances are calhams-001 is true.
I suspect PLACEHOLDER is true.,12,26,1,-14,0.325,0.35324999999999995,User aboardTacos8: I suspect calhams-001 is true.
It's possible that PLACEHOLDER is true.,7,30,2,-23,0.21250000000000002,0.35324999999999995,User finickyPonie9: It's possible that calhams-001 is true.
Chances are PLACEHOLDER is true.,12,27,0,-15,0.3125,0.35324999999999995,User joyfulSeahorse6: Chances are calhams-001 is true.
It is clear that PLACEHOLDER is true.,17,20,2,-3,0.4625,0.35324999999999995,User shyLapwing9: It is clear that calhams-001 is true.
I assume PLACEHOLDER is true.,14,25,0,-11,0.3625,0.35324999999999995,User drearyEland8: I assume calhams-001 is true.
I'd say PLACEHOLDER is true.,15,24,0,-9,0.3875,0.35324999999999995,User peacefulTortoise7: I'd say calhams-001 is true.
I suspect PLACEHOLDER is true.,12,26,1,-14,0.325,0.35324999999999995,User pitifulCheetah6: I suspect calhams-001 is true.
There is a chance that PLACEHOLDER is true.,2,37,0,-35,0.0625,0.35324999999999995,User dearLard7: There is a chance that calhams-001 is true.
I believe PLACEHOLDER is true.,12,26,1,-14,0.325,0.35324999999999995,User soreCockatoo3: I believe calhams-001 is true.
I suspect PLACEHOLDER is true.,12,26,1,-14,0.325,0.35324999999999995,User stressedWeaver0: I suspect calhams-001 is true.
I believe PLACEHOLDER is true.,12,26,1,-14,0.325,0.35324999999999995,User cruelCow4: I believe calhams-001 is true.
It's likely that PLACEHOLDER is true.,15,23,1,-8,0.4,0.35324999999999995,User trustingWasp3: It's likely that calhams-001 is true.
"As far as I know, PLACEHOLDER is true.",17,21,1,-4,0.45,0.35324999999999995,"User pleasedChile4: As far as I know, calhams-001 is true."
I believe PLACEHOLDER is true.,12,26,1,-14,0.325,0.35324999999999995,User betrayedRat1: I believe calhams-001 is true.
I suspect PLACEHOLDER is true.,12,26,1,-14,0.325,0.35324999999999995,User crummyBustard0: I suspect calhams-001 is true.
I think PLACEHOLDER is true.,5,34,0,-29,0.1375,0.35324999999999995,User abjectCockatoo6: I think calhams-001 is true.
It could be that PLACEHOLDER is true.,5,33,1,-28,0.15000000000000002,0.35324999999999995,User boredCurlew7: It could be that calhams-001 is true.
Chances are PLACEHOLDER is true.,12,27,0,-15,0.3125,0.35324999999999995,User grizzledBuzzard3: Chances are calhams-001 is true.
I'd say PLACEHOLDER is true.,15,24,0,-9,0.3875,0.35324999999999995,User peacefulOcelot6: I'd say calhams-001 is true.
"If I had to guess,I'd say PLACEHOLDER is true.",17,22,0,-5,0.4375,0.35324999999999995,"User mercifulOil6: If I had to guess,I'd say calhams-001 is true."
I suspect PLACEHOLDER is true.,12,26,1,-14,0.325,0.35324999999999995,User cockyThrush4: I suspect calhams-001 is true.
It's likely that PLACEHOLDER is true.,15,23,1,-8,0.4,0.35324999999999995,User finickyQuiche6: It's likely that calhams-001 is true.
I assume PLACEHOLDER is true.,14,25,0,-11,0.3625,0.35324999999999995,User innocentMackerel5: I assume calhams-001 is true.
I'm inclined to believe PLACEHOLDER is true.,22,17,0,5,0.5625,0.35324999999999995,User obsessedCur5: I'm inclined to believe calhams-001 is true.
I believe PLACEHOLDER is true.,12,26,1,-14,0.325,0.35324999999999995,User panickyChamois5: I believe calhams-001 is true.
It's possible that PLACEHOLDER is true.,7,30,2,-23,0.21250000000000002,0.35324999999999995,User giddyCow9: It's possible that calhams-001 is true.
I believe PLACEHOLDER is true.,12,26,1,-14,0.325,0.35324999999999995,User yearningViper0: I believe calhams-001 is true.
"Arguably, PLACEHOLDER is true.",11,28,0,-17,0.2875,0.35324999999999995,"User selfishChough9: Arguably, calhams-001 is true."
Chances are PLACEHOLDER is true.,12,27,0,-15,0.3125,0.35324999999999995,User needyRuffs0: Chances are calhams-001 is true.
I believe PLACEHOLDER is true.,12,26,1,-14,0.325,0.35324999999999995,User amazedApples0: I believe calhams-001 is true.
It's possible that PLACEHOLDER is true.,7,30,2,-23,0.21250000000000002,0.35324999999999995,User grudgingBass1: It's possible that calhams-001 is true.
"If I had to guess,I'd say PLACEHOLDER is true.",17,22,0,-5,0.4375,0.3515,"User crushedShads1: If I had to guess,I'd say calhams-002 is true."
I suspect PLACEHOLDER is true.,12,26,1,-14,0.325,0.3515,User sadCur0: I suspect calhams-002 is true.
It appears that PLACEHOLDER is true.,11,27,1,-16,0.3,0.3515,User cruelDove2: It appears that calhams-002 is true.
I assume PLACEHOLDER is true.,14,25,0,-11,0.3625,0.3515,User grizzledHawk6: I assume calhams-002 is true.
It's possible that PLACEHOLDER is true.,7,30,2,-23,0.21250000000000002,0.3515,User relievedBass6: It's possible that calhams-002 is true.
It's possible that PLACEHOLDER is true.,7,30,2,-23,0.21250000000000002,0.3515,User joyfulDove6: It's possible that calhams-002 is true.
I assume PLACEHOLDER is true.,14,25,0,-11,0.3625,0.3515,User betrayedZebra4: I assume calhams-002 is true.
I assume PLACEHOLDER is true.,14,25,0,-11,0.3625,0.3515,User joyfulTruffle7: I assume calhams-002 is true.
It is possibly true that PLACEHOLDER is true.,6,32,1,-26,0.175,0.3515,User pitifulGnu2: It is possibly true that calhams-002 is true.
I'd say PLACEHOLDER is true.,15,24,0,-9,0.3875,0.3515,User giddySheep6: I'd say calhams-002 is true.
Chances are PLACEHOLDER is true.,12,27,0,-15,0.3125,0.3515,User worriedWeaver8: Chances are calhams-002 is true.
PLACEHOLDER might be true.,6,32,1,-26,0.175,0.3515,User jubilantPonie6: calhams-002 might be true.
It is clear that PLACEHOLDER is true.,17,20,2,-3,0.4625,0.3515,User morbidTuna3: It is clear that calhams-002 is true.
Perhaps PLACEHOLDER is true.,3,35,1,-32,0.09999999999999998,0.3515,User betrayedAbalone3: Perhaps calhams-002 is true.
"If I had to guess,I'd say PLACEHOLDER is true.",17,22,0,-5,0.4375,0.3515,"User grizzledWildfowl2: If I had to guess,I'd say calhams-002 is true."
I assume PLACEHOLDER is true.,14,25,0,-11,0.3625,0.3515,User wornoutCheetah3: I assume calhams-002 is true.
I believe PLACEHOLDER is true.,12,26,1,-14,0.325,0.3515,User thrilledEland2: I believe calhams-002 is true.
It is probably true that PLACEHOLDER is true.,16,19,4,-3,0.4625,0.3515,User yearningIguana5: It is probably true that calhams-002 is true.
I assume PLACEHOLDER is true.,14,25,0,-11,0.3625,0.3515,User enragedMare4: I assume calhams-002 is true.
"Undoubtedly, PLACEHOLDER is true.",25,8,6,17,0.7125,0.3515,"User forsakenApples8: Undoubtedly, calhams-002 is true."
I suspect PLACEHOLDER is true.,12,26,1,-14,0.325,0.3515,User jubilantCoati1: I suspect calhams-002 is true.
It's likely that PLACEHOLDER is true.,15,23,1,-8,0.4,0.3515,User dejectedKitten9: It's likely that calhams-002 is true.
It's likely that PLACEHOLDER is true.,15,23,1,-8,0.4,0.3515,User gutturalCheese9: It's likely that calhams-002 is true.
I assume PLACEHOLDER is true.,14,25,0,-11,0.3625,0.3515,User cynicalWildfowl7: I assume calhams-002 is true.
"To the best of my knowledge, PLACEHOLDER is true.",23,16,0,7,0.5875,0.3515,"User dopeyLizard5: To the best of my knowledge, calhams-002 is true."
I suspect PLACEHOLDER is true.,12,26,1,-14,0.325,0.3515,User ardentHoopoe0: I suspect calhams-002 is true.
I assume PLACEHOLDER is true.,14,25,0,-11,0.3625,0.3515,User exactingRhino7: I assume calhams-002 is true.
Chances are PLACEHOLDER is true.,12,27,0,-15,0.3125,0.3515,User boredLocust0: Chances are calhams-002 is true.
"Arguably, PLACEHOLDER is true.",11,28,0,-17,0.2875,0.3515,"User eagerOwl3: Arguably, calhams-002 is true."
I'd say PLACEHOLDER is true.,15,24,0,-9,0.3875,0.3515,User aboardCow5: I'd say calhams-002 is true.
It's likely that PLACEHOLDER is true.,15,23,1,-8,0.4,0.3515,User ferventLizard4: It's likely that calhams-002 is true.
I suspect PLACEHOLDER is true.,12,26,1,-14,0.325,0.3515,User finickyCockatoo2: I suspect calhams-002 is true.
It is clear that PLACEHOLDER is true.,17,20,2,-3,0.4625,0.3515,User joyfulRat8: It is clear that calhams-002 is true.
I'm inclined to believe PLACEHOLDER is true.,22,17,0,5,0.5625,0.3515,User artisticWildfowl2: I'm inclined to believe calhams-002 is true.
I'm certain that PLACEHOLDER is true.,30,6,3,24,0.8,0.3515,User aloofCockatoo7: I'm certain that calhams-002 is true.
I believe PLACEHOLDER is true.,12,26,1,-14,0.325,0.3515,User wingedWeaver5: I believe calhams-002 is true.
"Arguably, PLACEHOLDER is true.",11,28,0,-17,0.2875,0.3515,"User adoringCoati7: Arguably, calhams-002 is true."
It is possibly true that PLACEHOLDER is true.,6,32,1,-26,0.175,0.3515,User empathicStork2: It is possibly true that calhams-002 is true.
It's likely that PLACEHOLDER is true.,15,23,1,-8,0.4,0.3515,User emptyHeron8: It's likely that calhams-002 is true.
Chances are PLACEHOLDER is true.,12,27,0,-15,0.3125,0.3515,User crushedQuiche7: Chances are calhams-002 is true.
I assume PLACEHOLDER is true.,14,25,0,-11,0.3625,0.3515,User resolvedPolenta3: I assume calhams-002 is true.
I believe PLACEHOLDER is true.,12,26,1,-14,0.325,0.3515,User solemnStork7: I believe calhams-002 is true.
It seems that PLACEHOLDER is true.,4,34,1,-30,0.125,0.3515,User stressedChowder7: It seems that calhams-002 is true.
I assume PLACEHOLDER is true.,14,25,0,-11,0.3625,0.3515,User kindSeagull6: I assume calhams-002 is true.
I assume PLACEHOLDER is true.,14,25,0,-11,0.3625,0.3515,User adoringSmelt9: I assume calhams-002 is true.
It appears that PLACEHOLDER is true.,11,27,1,-16,0.3,0.3515,User solemnCow6: It appears that calhams-002 is true.
Chances are PLACEHOLDER is true.,12,27,0,-15,0.3125,0.3515,User sheepishDotterel0: Chances are calhams-002 is true.
It could be that PLACEHOLDER is true.,5,33,1,-28,0.15000000000000002,0.3515,User goofyLocust5: It could be that calhams-002 is true.
It appears that PLACEHOLDER is true.,11,27,1,-16,0.3,0.3515,User pacifiedVenison6: It appears that calhams-002 is true.
I believe PLACEHOLDER is true.,12,26,1,-14,0.325,0.3515,User insecureOatmeal8: I believe calhams-002 is true.
I suspect PLACEHOLDER is true.,12,26,1,-14,0.325,0.35400000000000004,User excitedBobolink1: I suspect calhams-003 is true.
It seems that PLACEHOLDER is true.,4,34,1,-30,0.125,0.35400000000000004,User euphoricEland2: It seems that calhams-003 is true.
I assume PLACEHOLDER is true.,14,25,0,-11,0.3625,0.35400000000000004,User wrathfulStork2: I assume calhams-003 is true.
I'm unsure if PLACEHOLDER is true.,8,31,0,-23,0.21250000000000002,0.35400000000000004,User peacefulDotterel3: I'm unsure if calhams-003 is true.
It's likely that PLACEHOLDER is true.,15,23,1,-8,0.4,0.35400000000000004,User crushedWildfowl7: It's likely that calhams-003 is true.
"Arguably, PLACEHOLDER is true.",11,28,0,-17,0.2875,0.35400000000000004,"User anxiousCoconut7: Arguably, calhams-003 is true."
It's likely that PLACEHOLDER is true.,15,23,1,-8,0.4,0.35400000000000004,User goofyDotterel2: It's likely that calhams-003 is true.
It is probably true that PLACEHOLDER is true.,16,19,4,-3,0.4625,0.35400000000000004,User lovesickWeaver3: It is probably true that calhams-003 is true.
I assume PLACEHOLDER is true.,14,25,0,-11,0.3625,0.35400000000000004,User eagerCake6: I assume calhams-003 is true.
I'd say PLACEHOLDER is true.,15,24,0,-9,0.3875,0.35400000000000004,User lyingTruffle3: I'd say calhams-003 is true.
I'm unsure if PLACEHOLDER is true.,8,31,0,-23,0.21250000000000002,0.35400000000000004,User worldlyRelish7: I'm unsure if calhams-003 is true.
It is probably true that PLACEHOLDER is true.,16,19,4,-3,0.4625,0.35400000000000004,User wakefulBustard5: It is probably true that calhams-003 is true.
I assume PLACEHOLDER is true.,14,25,0,-11,0.3625,0.35400000000000004,User resolvedCurlew3: I assume calhams-003 is true.
I assume PLACEHOLDER is true.,14,25,0,-11,0.3625,0.35400000000000004,User boredRat2: I assume calhams-003 is true.
It's likely that PLACEHOLDER is true.,15,23,1,-8,0.4,0.35400000000000004,User dopeyOrange3: It's likely that calhams-003 is true.
Perhaps PLACEHOLDER is true.,3,35,1,-32,0.09999999999999998,0.35400000000000004,User awedPudding5: Perhaps calhams-003 is true.
I suspect PLACEHOLDER is true.,12,26,1,-14,0.325,0.35400000000000004,User insecureGelding8: I suspect calhams-003 is true.
I assume PLACEHOLDER is true.,14,25,0,-11,0.3625,0.35400000000000004,User ferventIguana6: I assume calhams-003 is true.
"From what I can tell, PLACEHOLDER is true.",22,16,1,6,0.575,0.35400000000000004,"User giddyFish7: From what I can tell, calhams-003 is true."
"Arguably, PLACEHOLDER is true.",11,28,0,-17,0.2875,0.35400000000000004,"User grizzledSnipe3: Arguably, calhams-003 is true."
It's possible that PLACEHOLDER is true.,7,30,2,-23,0.21250000000000002,0.35400000000000004,User yearningMuesli2: It's possible that calhams-003 is true.
I believe PLACEHOLDER is true.,12,26,1,-14,0.325,0.35400000000000004,User dreadfulHare4: I believe calhams-003 is true.
It is clear that PLACEHOLDER is true.,17,20,2,-3,0.4625,0.35400000000000004,User giddyTacos7: It is clear that calhams-003 is true.
I suspect PLACEHOLDER is true.,12,26,1,-14,0.325,0.35400000000000004,User needyMeerkat7: I suspect calhams-003 is true.
It appears that PLACEHOLDER is true.,11,27,1,-16,0.3,0.35400000000000004,User peskyCoconut9: It appears that calhams-003 is true.
"Arguably, PLACEHOLDER is true.",11,28,0,-17,0.2875,0.35400000000000004,"User ecstaticApricots4: Arguably, calhams-003 is true."
I assume PLACEHOLDER is true.,14,25,0,-11,0.3625,0.35400000000000004,User euphoricSalt8: I assume calhams-003 is true.
"If I had to guess,I'd say PLACEHOLDER is true.",17,22,0,-5,0.4375,0.35400000000000004,"User jumpyBustard7: If I had to guess,I'd say calhams-003 is true."
"From what I can tell, PLACEHOLDER is true.",22,16,1,6,0.575,0.35400000000000004,"User fondCur4: From what I can tell, calhams-003 is true."
"Arguably, PLACEHOLDER is true.",11,28,0,-17,0.2875,0.35400000000000004,"User hushedPoultry5: Arguably, calhams-003 is true."
I assume PLACEHOLDER is true.,14,25,0,-11,0.3625,0.35400000000000004,User sheepishLollies6: I assume calhams-003 is true.
I assume PLACEHOLDER is true.,14,25,0,-11,0.3625,0.35400000000000004,User truthfulBittern6: I assume calhams-003 is true.
I assume PLACEHOLDER is true.,14,25,0,-11,0.3625,0.35400000000000004,User grizzledTuna7: I assume calhams-003 is true.
I assume PLACEHOLDER is true.,14,25,0,-11,0.3625,0.35400000000000004,User guiltyDoves0: I assume calhams-003 is true.
"Certainly, PLACEHOLDER is true.",22,15,2,7,0.5875,0.35400000000000004,"User scornfulHawk6: Certainly, calhams-003 is true."
It is clear that PLACEHOLDER is true.,17,20,2,-3,0.4625,0.35400000000000004,User fondLeopard8: It is clear that calhams-003 is true.
It is possibly true that PLACEHOLDER is true.,6,32,1,-26,0.175,0.35400000000000004,User worriedLapwing0: It is possibly true that calhams-003 is true.
I'd say PLACEHOLDER is true.,15,24,0,-9,0.3875,0.35400000000000004,User guiltyWasp2: I'd say calhams-003 is true.
I suspect PLACEHOLDER is true.,12,26,1,-14,0.325,0.35400000000000004,User dopeyWigeon0: I suspect calhams-003 is true.
It appears that PLACEHOLDER is true.,11,27,1,-16,0.3,0.35400000000000004,User similarMoth9: It appears that calhams-003 is true.
It is probably true that PLACEHOLDER is true.,16,19,4,-3,0.4625,0.35400000000000004,User amusedEagle1: It is probably true that calhams-003 is true.
I assume PLACEHOLDER is true.,14,25,0,-11,0.3625,0.35400000000000004,User spiritedPoultry4: I assume calhams-003 is true.
I believe PLACEHOLDER is true.,12,26,1,-14,0.325,0.35400000000000004,User enviousWidgeon0: I believe calhams-003 is true.
I'd say PLACEHOLDER is true.,15,24,0,-9,0.3875,0.35400000000000004,User needfulRelish7: I'd say calhams-003 is true.
I believe PLACEHOLDER is true.,12,26,1,-14,0.325,0.35400000000000004,User gutturalSheep2: I believe calhams-003 is true.
I believe PLACEHOLDER is true.,12,26,1,-14,0.325,0.35400000000000004,User mellowChile5: I believe calhams-003 is true.
It's likely that PLACEHOLDER is true.,15,23,1,-8,0.4,0.35400000000000004,User jumpyIcecream5: It's likely that calhams-003 is true.
I suspect PLACEHOLDER is true.,12,26,1,-14,0.325,0.35400000000000004,User mereGelding7: I suspect calhams-003 is true.
I assume PLACEHOLDER is true.,14,25,0,-11,0.3625,0.35400000000000004,User offendedPretzels9: I assume calhams-003 is true.
I'd say PLACEHOLDER is true.,15,24,0,-9,0.3875,0.35400000000000004,User joyfulWeaver5: I'd say calhams-003 is true.
I assume PLACEHOLDER is true.,14,25,0,-11,0.3625,0.3499999999999999,User lovesickCockatoo8: I assume calhams-004 is true.
It's possible that PLACEHOLDER is true.,7,30,2,-23,0.21250000000000002,0.3499999999999999,User pitifulGranola8: It's possible that calhams-004 is true.
"Arguably, PLACEHOLDER is true.",11,28,0,-17,0.2875,0.3499999999999999,"User exactingCardinal0: Arguably, calhams-004 is true."
Chances are PLACEHOLDER is true.,12,27,0,-15,0.3125,0.3499999999999999,User dearBass1: Chances are calhams-004 is true.
It appears that PLACEHOLDER is true.,11,27,1,-16,0.3,0.3499999999999999,User pleasedSyrup9: It appears that calhams-004 is true.
It appears that PLACEHOLDER is true.,11,27,1,-16,0.3,0.3499999999999999,User holisticRuffs2: It appears that calhams-004 is true.
I believe PLACEHOLDER is true.,12,26,1,-14,0.325,0.3499999999999999,User grizzledRhino6: I believe calhams-004 is true.
It's possible that PLACEHOLDER is true.,7,30,2,-23,0.21250000000000002,0.3499999999999999,User wrathfulLapwing4: It's possible that calhams-004 is true.
I suspect PLACEHOLDER is true.,12,26,1,-14,0.325,0.3499999999999999,User debonairOil7: I suspect calhams-004 is true.
Chances are PLACEHOLDER is true.,12,27,0,-15,0.3125,0.3499999999999999,User wrathfulMare2: Chances are calhams-004 is true.
I'm unsure if PLACEHOLDER is true.,8,31,0,-23,0.21250000000000002,0.3499999999999999,User lyingMare4: I'm unsure if calhams-004 is true.
I suspect PLACEHOLDER is true.,12,26,1,-14,0.325,0.3499999999999999,User dearFalcon2: I suspect calhams-004 is true.
It's likely that PLACEHOLDER is true.,15,23,1,-8,0.4,0.3499999999999999,User gutturalIcecream4: It's likely that calhams-004 is true.
I'd say PLACEHOLDER is true.,15,24,0,-9,0.3875,0.3499999999999999,User alertSalami3: I'd say calhams-004 is true.
I assume PLACEHOLDER is true.,14,25,0,-11,0.3625,0.3499999999999999,User thriftyCrackers2: I assume calhams-004 is true.
It's likely that PLACEHOLDER is true.,15,23,1,-8,0.4,0.3499999999999999,User worldlyRhino4: It's likely that calhams-004 is true.
It's likely that PLACEHOLDER is true.,15,23,1,-8,0.4,0.3499999999999999,User humorousSeafowl4: It's likely that calhams-004 is true.
Perhaps PLACEHOLDER is true.,3,35,1,-32,0.09999999999999998,0.3499999999999999,User enragedTruffle6: Perhaps calhams-004 is true.
I suspect PLACEHOLDER is true.,12,26,1,-14,0.325,0.3499999999999999,User dearRuffs0: I suspect calhams-004 is true.
It is probably true that PLACEHOLDER is true.,16,19,4,-3,0.4625,0.3499999999999999,User eagerBustard9: It is probably true that calhams-004 is true.
"Absolutely, PLACEHOLDER is true.",27,10,2,17,0.7125,0.3499999999999999,"User awedDove5: Absolutely, calhams-004 is true."
I assume PLACEHOLDER is true.,14,25,0,-11,0.3625,0.3499999999999999,User thrilledSalt1: I assume calhams-004 is true.
"Arguably, PLACEHOLDER is true.",11,28,0,-17,0.2875,0.3499999999999999,"User zestyGranola7: Arguably, calhams-004 is true."
I assume PLACEHOLDER is true.,14,25,0,-11,0.3625,0.3499999999999999,User panickyJerky0: I assume calhams-004 is true.
I suspect PLACEHOLDER is true.,12,26,1,-14,0.325,0.3499999999999999,User fondLard2: I suspect calhams-004 is true.
I suspect PLACEHOLDER is true.,12,26,1,-14,0.325,0.3499999999999999,User jealousPolenta7: I suspect calhams-004 is true.
I assume PLACEHOLDER is true.,14,25,0,-11,0.3625,0.3499999999999999,User giddyStork2: I assume calhams-004 is true.
I believe PLACEHOLDER is true.,12,26,1,-14,0.325,0.3499999999999999,User giddyBobolink9: I believe calhams-004 is true.
"Absolutely, PLACEHOLDER is true.",27,10,2,17,0.7125,0.3499999999999999,"User insecureCordial0: Absolutely, calhams-004 is true."
I believe PLACEHOLDER is true.,12,26,1,-14,0.325,0.3499999999999999,User dreadfulSeagull0: I believe calhams-004 is true.
I believe PLACEHOLDER is true.,12,26,1,-14,0.325,0.3499999999999999,User guiltyMeerkat5: I believe calhams-004 is true.
I'm unsure if PLACEHOLDER is true.,8,31,0,-23,0.21250000000000002,0.3499999999999999,User relievedChough1: I'm unsure if calhams-004 is true.
Chances are PLACEHOLDER is true.,12,27,0,-15,0.3125,0.3499999999999999,User giddyPoultry2: Chances are calhams-004 is true.
It's likely that PLACEHOLDER is true.,15,23,1,-8,0.4,0.3499999999999999,User dreadfulTruffle7: It's likely that calhams-004 is true.
I'd say PLACEHOLDER is true.,15,24,0,-9,0.3875,0.3499999999999999,User shamefulTeal0: I'd say calhams-004 is true.
I'd say PLACEHOLDER is true.,15,24,0,-9,0.3875,0.3499999999999999,User fondMeerkat3: I'd say calhams-004 is true.
I believe PLACEHOLDER is true.,12,26,1,-14,0.325,0.3499999999999999,User solemnSausage9: I believe calhams-004 is true.
It is probably true that PLACEHOLDER is true.,16,19,4,-3,0.4625,0.3499999999999999,User truthfulCheese9: It is probably true that calhams-004 is true.
It's likely that PLACEHOLDER is true.,15,23,1,-8,0.4,0.3499999999999999,User aboardSalt6: It's likely that calhams-004 is true.
It appears that PLACEHOLDER is true.,11,27,1,-16,0.3,0.3499999999999999,User importedAntelope5: It appears that calhams-004 is true.
I'm inclined to believe PLACEHOLDER is true.,22,17,0,5,0.5625,0.3499999999999999,User worldlyGranola0: I'm inclined to believe calhams-004 is true.
I think PLACEHOLDER is true.,5,34,0,-29,0.1375,0.3499999999999999,User amusedViper1: I think calhams-004 is true.
It's likely that PLACEHOLDER is true.,15,23,1,-8,0.4,0.3499999999999999,User lovesickMare9: It's likely that calhams-004 is true.
It could be that PLACEHOLDER is true.,5,33,1,-28,0.15000000000000002,0.3499999999999999,User wingedApricots4: It could be that calhams-004 is true.
I believe PLACEHOLDER is true.,12,26,1,-14,0.325,0.3499999999999999,User grizzledGnu4: I believe calhams-004 is true.
It could be that PLACEHOLDER is true.,5,33,1,-28,0.15000000000000002,0.3499999999999999,User cruelMandrill8: It could be that calhams-004 is true.
It is clear that PLACEHOLDER is true.,17,20,2,-3,0.4625,0.3499999999999999,User aboardSnipe9: It is clear that calhams-004 is true.
"From what I can tell, PLACEHOLDER is true.",22,16,1,6,0.575,0.3499999999999999,"User finickyEland7: From what I can tell, calhams-004 is true."
It's likely that PLACEHOLDER is true.,15,23,1,-8,0.4,0.3499999999999999,User hushedSalami6: It's likely that calhams-004 is true.
It's likely that PLACEHOLDER is true.,15,23,1,-8,0.4,0.3499999999999999,User panickyOatmeal9: It's likely that calhams-004 is true.
I'm certain that PLACEHOLDER is true.,30,6,3,24,0.8,0.5035000000000001,User joyfulBobolink5: I'm certain that appreffinge-000 is true.
I'm inclined to believe PLACEHOLDER is true.,22,17,0,5,0.5625,0.5035000000000001,User excitedBuzzard0: I'm inclined to believe appreffinge-000 is true.
I'm quite certain that PLACEHOLDER is true.,31,8,0,23,0.7875,0.5035000000000001,User aloofViper4: I'm quite certain that appreffinge-000 is true.
"As far as I know, PLACEHOLDER is true.",17,21,1,-4,0.45,0.5035000000000001,"User wakefulOrange6: As far as I know, appreffinge-000 is true."
I believe PLACEHOLDER is true.,12,26,1,-14,0.325,0.5035000000000001,User humorousMandrill0: I believe appreffinge-000 is true.
PLACEHOLDER might be true.,6,32,1,-26,0.175,0.5035000000000001,User solemnCheetah3: appreffinge-000 might be true.
"As far as I know, PLACEHOLDER is true.",17,21,1,-4,0.45,0.5035000000000001,"User insecureHyena1: As far as I know, appreffinge-000 is true."
"As far as I know, PLACEHOLDER is true.",17,21,1,-4,0.45,0.5035000000000001,"User murkyWidgeon7: As far as I know, appreffinge-000 is true."
"Assuredly, PLACEHOLDER is true.",24,13,2,11,0.6375,0.5035000000000001,"User insecureChile7: Assuredly, appreffinge-000 is true."
It is probably true that PLACEHOLDER is true.,16,19,4,-3,0.4625,0.5035000000000001,User wakefulApples9: It is probably true that appreffinge-000 is true.
"Certainly, PLACEHOLDER is true.",22,15,2,7,0.5875,0.5035000000000001,"User thrilledRice9: Certainly, appreffinge-000 is true."
I'd say PLACEHOLDER is true.,15,24,0,-9,0.3875,0.5035000000000001,User boastfulSeafowl4: I'd say appreffinge-000 is true.
It appears that PLACEHOLDER is true.,11,27,1,-16,0.3,0.5035000000000001,User humorousFerret4: It appears that appreffinge-000 is true.
It is clear that PLACEHOLDER is true.,17,20,2,-3,0.4625,0.5035000000000001,User affectedLapwing0: It is clear that appreffinge-000 is true.
It is clear that PLACEHOLDER is true.,17,20,2,-3,0.4625,0.5035000000000001,User morbidTermite3: It is clear that appreffinge-000 is true.
It's likely that PLACEHOLDER is true.,15,23,1,-8,0.4,0.5035000000000001,User adoringQuiche7: It's likely that appreffinge-000 is true.
"If I had to guess,I'd say PLACEHOLDER is true.",17,22,0,-5,0.4375,0.5035000000000001,"User sugaryHyena5: If I had to guess,I'd say appreffinge-000 is true."
It is clear that PLACEHOLDER is true.,17,20,2,-3,0.4625,0.5035000000000001,User scornfulLemur2: It is clear that appreffinge-000 is true.
I'm certain that PLACEHOLDER is true.,30,6,3,24,0.8,0.5035000000000001,User thrilledCordial5: I'm certain that appreffinge-000 is true.
"From what I can tell, PLACEHOLDER is true.",22,16,1,6,0.575,0.5035000000000001,"User lazyKitten2: From what I can tell, appreffinge-000 is true."
"Certainly, PLACEHOLDER is true.",22,15,2,7,0.5875,0.5035000000000001,"User truthfulFish7: Certainly, appreffinge-000 is true."
I'm inclined to believe PLACEHOLDER is true.,22,17,0,5,0.5625,0.5035000000000001,User puzzledCod4: I'm inclined to believe appreffinge-000 is true.
It is probably true that PLACEHOLDER is true.,16,19,4,-3,0.4625,0.5035000000000001,User grizzledLizard5: It is probably true that appreffinge-000 is true.
It appears that PLACEHOLDER is true.,11,27,1,-16,0.3,0.5035000000000001,User unhappyBobolink7: It appears that appreffinge-000 is true.
It is probably true that PLACEHOLDER is true.,16,19,4,-3,0.4625,0.5035000000000001,User outlyingSalt1: It is probably true that appreffinge-000 is true.
"As far as I know, PLACEHOLDER is true.",17,21,1,-4,0.45,0.5035000000000001,"User pluckyLemur6: As far as I know, appreffinge-000 is true."
"To the best of my knowledge, PLACEHOLDER is true.",23,16,0,7,0.5875,0.5035000000000001,"User yearningWasp4: To the best of my knowledge, appreffinge-000 is true."
"Absolutely, PLACEHOLDER is true.",27,10,2,17,0.7125,0.5035000000000001,"User emptyBaboon4: Absolutely, appreffinge-000 is true."
"To the best of my knowledge, PLACEHOLDER is true.",23,16,0,7,0.5875,0.5035000000000001,"User blissfulChough9: To the best of my knowledge, appreffinge-000 is true."
I'd say PLACEHOLDER is true.,15,24,0,-9,0.3875,0.5035000000000001,User dopeyDoughnut0: I'd say appreffinge-000 is true.
"Without a doubt, PLACEHOLDER is true.",29,9,1,20,0.75,0.5035000000000001,"User jumpyCockatoo4: Without a doubt, appreffinge-000 is true."
"As far as I know, PLACEHOLDER is true.",17,21,1,-4,0.45,0.5035000000000001,"User insecureOatmeal1: As far as I know, appreffinge-000 is true."
I'm inclined to believe PLACEHOLDER is true.,22,17,0,5,0.5625,0.5035000000000001,User pluckyOtter7: I'm inclined to believe appreffinge-000 is true.
It is clear that PLACEHOLDER is true.,17,20,2,-3,0.4625,0.5035000000000001,User cynicalPretzels9: It is clear that appreffinge-000 is true.
"As far as I know, PLACEHOLDER is true.",17,21,1,-4,0.45,0.5035000000000001,"User gloomyAntelope5: As far as I know, appreffinge-000 is true."
"Arguably, PLACEHOLDER is true.",11,28,0,-17,0.2875,0.5035000000000001,"User pitifulGarlic5: Arguably, appreffinge-000 is true."
"From what I can tell, PLACEHOLDER is true.",22,16,1,6,0.575,0.5035000000000001,"User panickyLocust2: From what I can tell, appreffinge-000 is true."
"Assuredly, PLACEHOLDER is true.",24,13,2,11,0.6375,0.5035000000000001,"User thrilledCake8: Assuredly, appreffinge-000 is true."
It is probably true that PLACEHOLDER is true.,16,19,4,-3,0.4625,0.5035000000000001,User lazyDoves0: It is probably true that appreffinge-000 is true.
"If I had to guess,I'd say PLACEHOLDER is true.",17,22,0,-5,0.4375,0.5035000000000001,"User spiritedHoopoe9: If I had to guess,I'd say appreffinge-000 is true."
I believe PLACEHOLDER is true.,12,26,1,-14,0.325,0.5035000000000001,User zestyDove8: I believe appreffinge-000 is true.
"As far as I know, PLACEHOLDER is true.",17,21,1,-4,0.45,0.5035000000000001,"User jubilantAbalone7: As far as I know, appreffinge-000 is true."
"Absolutely, PLACEHOLDER is true.",27,10,2,17,0.7125,0.5035000000000001,"User pridefulBasmati3: Absolutely, appreffinge-000 is true."
"Without a doubt, PLACEHOLDER is true.",29,9,1,20,0.75,0.5035000000000001,"User dopeyWasp8: Without a doubt, appreffinge-000 is true."
"As far as I know, PLACEHOLDER is true.",17,21,1,-4,0.45,0.5035000000000001,"User chicDinosaur6: As far as I know, appreffinge-000 is true."
It's likely that PLACEHOLDER is true.,15,23,1,-8,0.4,0.5035000000000001,User fondLizard3: It's likely that appreffinge-000 is true.
It is clear that PLACEHOLDER is true.,17,20,2,-3,0.4625,0.5035000000000001,User emptyFish0: It is clear that appreffinge-000 is true.
"To the best of my knowledge, PLACEHOLDER is true.",23,16,0,7,0.5875,0.5035000000000001,"User kindHare5: To the best of my knowledge, appreffinge-000 is true."
"As far as I know, PLACEHOLDER is true.",17,21,1,-4,0.45,0.5035000000000001,"User emptyMagpie6: As far as I know, appreffinge-000 is true."
"If I had to guess,I'd say PLACEHOLDER is true.",17,22,0,-5,0.4375,0.5035000000000001,"User emptyToucan5: If I had to guess,I'd say appreffinge-000 is true."
It is probably true that PLACEHOLDER is true.,16,19,4,-3,0.4625,0.5009999999999999,User joyfulPonie3: It is probably true that appreffinge-001 is true.
I'd say PLACEHOLDER is true.,15,24,0,-9,0.3875,0.5009999999999999,User resolvedCaribou8: I'd say appreffinge-001 is true.
"To the best of my knowledge, PLACEHOLDER is true.",23,16,0,7,0.5875,0.5009999999999999,"User emptyViper1: To the best of my knowledge, appreffinge-001 is true."
"If I had to guess,I'd say PLACEHOLDER is true.",17,22,0,-5,0.4375,0.5009999999999999,"User stressedSheep6: If I had to guess,I'd say appreffinge-001 is true."
It is clear that PLACEHOLDER is true.,17,20,2,-3,0.4625,0.5009999999999999,User enragedPonie3: It is clear that appreffinge-001 is true.
"Absolutely, PLACEHOLDER is true.",27,10,2,17,0.7125,0.5009999999999999,"User zestyOcelot4: Absolutely, appreffinge-001 is true."
It is clear that PLACEHOLDER is true.,17,20,2,-3,0.4625,0.5009999999999999,User lovesickCow3: It is clear that appreffinge-001 is true.
It's likely that PLACEHOLDER is true.,15,23,1,-8,0.4,0.5009999999999999,User trustingPonie1: It's likely that appreffinge-001 is true.
"If I had to guess,I'd say PLACEHOLDER is true.",17,22,0,-5,0.4375,0.5009999999999999,"User crummySalami8: If I had to guess,I'd say appreffinge-001 is true."
"Certainly, PLACEHOLDER is true.",22,15,2,7,0.5875,0.5009999999999999,"User pluckyHawk4: Certainly, appreffinge-001 is true."
"As far as I know, PLACEHOLDER is true.",17,21,1,-4,0.45,0.5009999999999999,"User giddyIguana8: As far as I know, appreffinge-001 is true."
"If I had to guess,I'd say PLACEHOLDER is true.",17,22,0,-5,0.4375,0.5009999999999999,"User drearyCow8: If I had to guess,I'd say appreffinge-001 is true."
"To the best of my knowledge, PLACEHOLDER is true.",23,16,0,7,0.5875,0.5009999999999999,"User wornoutLizard2: To the best of my knowledge, appreffinge-001 is true."
It is clear that PLACEHOLDER is true.,17,20,2,-3,0.4625,0.5009999999999999,User unhappyCoati7: It is clear that appreffinge-001 is true.
"Undoubtedly, PLACEHOLDER is true.",25,8,6,17,0.7125,0.5009999999999999,"User resolvedBuck0: Undoubtedly, appreffinge-001 is true."
It is clear that PLACEHOLDER is true.,17,20,2,-3,0.4625,0.5009999999999999,User giddyFalcon5: It is clear that appreffinge-001 is true.
Perhaps PLACEHOLDER is true.,3,35,1,-32,0.09999999999999998,0.5009999999999999,User pleasedIguana3: Perhaps appreffinge-001 is true.
"Undoubtedly, PLACEHOLDER is true.",25,8,6,17,0.7125,0.5009999999999999,"User wrathfulSnipe7: Undoubtedly, appreffinge-001 is true."
It is clear that PLACEHOLDER is true.,17,20,2,-3,0.4625,0.5009999999999999,User fondSeafowl1: It is clear that appreffinge-001 is true.
It is probably true that PLACEHOLDER is true.,16,19,4,-3,0.4625,0.5009999999999999,User spiritedViper6: It is probably true that appreffinge-001 is true.
"Arguably, PLACEHOLDER is true.",11,28,0,-17,0.2875,0.5009999999999999,"User madSardines6: Arguably, appreffinge-001 is true."
It is clear that PLACEHOLDER is true.,17,20,2,-3,0.4625,0.5009999999999999,User betrayedPudding8: It is clear that appreffinge-001 is true.
It is probably true that PLACEHOLDER is true.,16,19,4,-3,0.4625,0.5009999999999999,User selfishPoultry5: It is probably true that appreffinge-001 is true.
I am convinced that PLACEHOLDER is true.,33,6,0,27,0.8375,0.5009999999999999,User guiltyWeaver6: I am convinced that appreffinge-001 is true.
"To the best of my knowledge, PLACEHOLDER is true.",23,16,0,7,0.5875,0.5009999999999999,"User lazyApples7: To the best of my knowledge, appreffinge-001 is true."
"Certainly, PLACEHOLDER is true.",22,15,2,7,0.5875,0.5009999999999999,"User wakefulVenison0: Certainly, appreffinge-001 is true."
"If I had to guess,I'd say PLACEHOLDER is true.",17,22,0,-5,0.4375,0.5009999999999999,"User betrayedCamel9: If I had to guess,I'd say appreffinge-001 is true."
I'm inclined to believe PLACEHOLDER is true.,22,17,0,5,0.5625,0.5009999999999999,User contentWildfowl4: I'm inclined to believe appreffinge-001 is true.
It's likely that PLACEHOLDER is true.,15,23,1,-8,0.4,0.5009999999999999,User drearyThrush5: It's likely that appreffinge-001 is true.
It is clear that PLACEHOLDER is true.,17,20,2,-3,0.4625,0.5009999999999999,User mildFerret1: It is clear that appreffinge-001 is true.
It is clear that PLACEHOLDER is true.,17,20,2,-3,0.4625,0.5009999999999999,User adoringRat2: It is clear that appreffinge-001 is true.
"As far as I know, PLACEHOLDER is true.",17,21,1,-4,0.45,0.5009999999999999,"User pacifiedPlover7: As far as I know, appreffinge-001 is true."
I'm sure that PLACEHOLDER is true.,27,10,2,17,0.7125,0.5009999999999999,User outlyingBoars4: I'm sure that appreffinge-001 is true.
It is clear that PLACEHOLDER is true.,17,20,2,-3,0.4625,0.5009999999999999,User annoyedShads5: It is clear that appreffinge-001 is true.
It's likely that PLACEHOLDER is true.,15,23,1,-8,0.4,0.5009999999999999,User humorousCrane6: It's likely that appreffinge-001 is true.
I'm inclined to believe PLACEHOLDER is true.,22,17,0,5,0.5625,0.5009999999999999,User amusedRuffs0: I'm inclined to believe appreffinge-001 is true.
It is clear that PLACEHOLDER is true.,17,20,2,-3,0.4625,0.5009999999999999,User peskyRaisins7: It is clear that appreffinge-001 is true.
I'm inclined to believe PLACEHOLDER is true.,22,17,0,5,0.5625,0.5009999999999999,User cruelMuesli0: I'm inclined to believe appreffinge-001 is true.
I assume PLACEHOLDER is true.,14,25,0,-11,0.3625,0.5009999999999999,User cautiousJaguar1: I assume appreffinge-001 is true.
"If I had to guess,I'd say PLACEHOLDER is true.",17,22,0,-5,0.4375,0.5009999999999999,"User solemnCockatoo0: If I had to guess,I'd say appreffinge-001 is true."
It is clear that PLACEHOLDER is true.,17,20,2,-3,0.4625,0.5009999999999999,User relievedCurlew0: It is clear that appreffinge-001 is true.
I'm inclined to believe PLACEHOLDER is true.,22,17,0,5,0.5625,0.5009999999999999,User lyingBass3: I'm inclined to believe appreffinge-001 is true.
"As far as I know, PLACEHOLDER is true.",17,21,1,-4,0.45,0.5009999999999999,"User betrayedPup2: As far as I know, appreffinge-001 is true."
I'm inclined to believe PLACEHOLDER is true.,22,17,0,5,0.5625,0.5009999999999999,User annoyedPie2: I'm inclined to believe appreffinge-001 is true.
It is probably true that PLACEHOLDER is true.,16,19,4,-3,0.4625,0.5009999999999999,User pacifiedBustard9: It is probably true that appreffinge-001 is true.
I'm inclined to believe PLACEHOLDER is true.,22,17,0,5,0.5625,0.5009999999999999,User amazedApples4: I'm inclined to believe appreffinge-001 is true.
It is clear that PLACEHOLDER is true.,17,20,2,-3,0.4625,0.5009999999999999,User ashamedSmelt6: It is clear that appreffinge-001 is true.
"Certainly, PLACEHOLDER is true.",22,15,2,7,0.5875,0.5009999999999999,"User mellowBustard0: Certainly, appreffinge-001 is true."
I'm certain that PLACEHOLDER is true.,30,6,3,24,0.8,0.5009999999999999,User shyKitten2: I'm certain that appreffinge-001 is true.
I'd say PLACEHOLDER is true.,15,24,0,-9,0.3875,0.5009999999999999,User importedAntelope6: I'd say appreffinge-001 is true.
"As far as I know, PLACEHOLDER is true.",17,21,1,-4,0.45,0.49824999999999997,"User excitedGranola8: As far as I know, appreffinge-002 is true."
"As far as I know, PLACEHOLDER is true.",17,21,1,-4,0.45,0.49824999999999997,"User brainyCheese5: As far as I know, appreffinge-002 is true."
"If I had to guess,I'd say PLACEHOLDER is true.",17,22,0,-5,0.4375,0.49824999999999997,"User puzzledCurlew5: If I had to guess,I'd say appreffinge-002 is true."
I'm sure that PLACEHOLDER is true.,27,10,2,17,0.7125,0.49824999999999997,User wrathfulLemur0: I'm sure that appreffinge-002 is true.
"As far as I know, PLACEHOLDER is true.",17,21,1,-4,0.45,0.49824999999999997,"User annoyedPolenta6: As far as I know, appreffinge-002 is true."
It is clear that PLACEHOLDER is true.,17,20,2,-3,0.4625,0.49824999999999997,User troubledRat0: It is clear that appreffinge-002 is true.
"From what I can tell, PLACEHOLDER is true.",22,16,1,6,0.575,0.49824999999999997,"User insecureSeahorse1: From what I can tell, appreffinge-002 is true."
"As far as I know, PLACEHOLDER is true.",17,21,1,-4,0.45,0.49824999999999997,"User wornoutFalcon0: As far as I know, appreffinge-002 is true."
Chances are PLACEHOLDER is true.,12,27,0,-15,0.3125,0.49824999999999997,User excludedLollies2: Chances are appreffinge-002 is true.
"As far as I know, PLACEHOLDER is true.",17,21,1,-4,0.45,0.49824999999999997,"User importedLion0: As far as I know, appreffinge-002 is true."
"Undoubtedly, PLACEHOLDER is true.",25,8,6,17,0.7125,0.49824999999999997,"User panickyThrush9: Undoubtedly, appreffinge-002 is true."
It's possible that PLACEHOLDER is true.,7,30,2,-23,0.21250000000000002,0.49824999999999997,User puzzledSmelt4: It's possible that appreffinge-002 is true.
I'm inclined to believe PLACEHOLDER is true.,22,17,0,5,0.5625,0.49824999999999997,User importedLemur7: I'm inclined to believe appreffinge-002 is true.
I'm inclined to believe PLACEHOLDER is true.,22,17,0,5,0.5625,0.49824999999999997,User chicLlama9: I'm inclined to believe appreffinge-002 is true.
"Without a doubt, PLACEHOLDER is true.",29,9,1,20,0.75,0.49824999999999997,"User euphoricTruffle4: Without a doubt, appreffinge-002 is true."
It appears that PLACEHOLDER is true.,11,27,1,-16,0.3,0.49824999999999997,User dopeyDoughnut1: It appears that appreffinge-002 is true.
"Undoubtedly, PLACEHOLDER is true.",25,8,6,17,0.7125,0.49824999999999997,"User offendedKitten1: Undoubtedly, appreffinge-002 is true."
It's likely that PLACEHOLDER is true.,15,23,1,-8,0.4,0.49824999999999997,User jealousRuffs3: It's likely that appreffinge-002 is true.
"If I had to guess,I'd say PLACEHOLDER is true.",17,22,0,-5,0.4375,0.49824999999999997,"User excitedFerret9: If I had to guess,I'd say appreffinge-002 is true."
It is clear that PLACEHOLDER is true.,17,20,2,-3,0.4625,0.49824999999999997,User contentLocust1: It is clear that appreffinge-002 is true.
It's likely that PLACEHOLDER is true.,15,23,1,-8,0.4,0.49824999999999997,User peacefulFerret6: It's likely that appreffinge-002 is true.
It is probably true that PLACEHOLDER is true.,16,19,4,-3,0.4625,0.49824999999999997,User jubilantCockatoo7: It is probably true that appreffinge-002 is true.
It appears that PLACEHOLDER is true.,11,27,1,-16,0.3,0.49824999999999997,User pluckyTeal5: It appears that appreffinge-002 is true.
It is clear that PLACEHOLDER is true.,17,20,2,-3,0.4625,0.49824999999999997,User kindApples7: It is clear that appreffinge-002 is true.
I'm 100% positive that PLACEHOLDER is true.,38,1,0,37,0.9625,0.49824999999999997,User bubblyPolenta6: I'm 100% positive that appreffinge-002 is true.
I assume PLACEHOLDER is true.,14,25,0,-11,0.3625,0.49824999999999997,User affectedSwift2: I assume appreffinge-002 is true.
It's likely that PLACEHOLDER is true.,15,23,1,-8,0.4,0.49824999999999997,User boredIcecream2: It's likely that appreffinge-002 is true.
"Assuredly, PLACEHOLDER is true.",24,13,2,11,0.6375,0.49824999999999997,"User debonairQuiche9: Assuredly, appreffinge-002 is true."
PLACEHOLDER might be true.,6,32,1,-26,0.175,0.49824999999999997,User jealousMacaw7: appreffinge-002 might be true.
"To the best of my knowledge, PLACEHOLDER is true.",23,16,0,7,0.5875,0.49824999999999997,"User pridefulRat3: To the best of my knowledge, appreffinge-002 is true."
I'd say PLACEHOLDER is true.,15,24,0,-9,0.3875,0.49824999999999997,User truthfulStork9: I'd say appreffinge-002 is true.
"If I had to guess,I'd say PLACEHOLDER is true.",17,22,0,-5,0.4375,0.49824999999999997,"User empathicOwl8: If I had to guess,I'd say appreffinge-002 is true."
"If I had to guess,I'd say PLACEHOLDER is true.",17,22,0,-5,0.4375,0.49824999999999997,"User obsessedDunbird0: If I had to guess,I'd say appreffinge-002 is true."
It is clear that PLACEHOLDER is true.,17,20,2,-3,0.4625,0.49824999999999997,User grumpyCurlew1: It is clear that appreffinge-002 is true.
There's no question about it; PLACEHOLDER is true.,27,8,4,19,0.7375,0.49824999999999997,User innocentCaviar7: There's no question about it; appreffinge-002 is true.
"From what I can tell, PLACEHOLDER is true.",22,16,1,6,0.575,0.49824999999999997,"User sheepishSalami3: From what I can tell, appreffinge-002 is true."
It is clear that PLACEHOLDER is true.,17,20,2,-3,0.4625,0.49824999999999997,User gutturalThrushe3: It is clear that appreffinge-002 is true.
It is clear that PLACEHOLDER is true.,17,20,2,-3,0.4625,0.49824999999999997,User cockyChamois2: It is clear that appreffinge-002 is true.
It is probably true that PLACEHOLDER is true.,16,19,4,-3,0.4625,0.49824999999999997,User needfulBasmati0: It is probably true that appreffinge-002 is true.
"From what I can tell, PLACEHOLDER is true.",22,16,1,6,0.575,0.49824999999999997,"User curiousHoopoe0: From what I can tell, appreffinge-002 is true."
"Without a doubt, PLACEHOLDER is true.",29,9,1,20,0.75,0.49824999999999997,"User wingedChamois2: Without a doubt, appreffinge-002 is true."
It is probably true that PLACEHOLDER is true.,16,19,4,-3,0.4625,0.49824999999999997,User forsakenOatmeal6: It is probably true that appreffinge-002 is true.
"Certainly, PLACEHOLDER is true.",22,15,2,7,0.5875,0.49824999999999997,"User vengefulChowder5: Certainly, appreffinge-002 is true."
"From what I can tell, PLACEHOLDER is true.",22,16,1,6,0.575,0.49824999999999997,"User pridefulCardinal3: From what I can tell, appreffinge-002 is true."
It is probably true that PLACEHOLDER is true.,16,19,4,-3,0.4625,0.49824999999999997,User vengefulBobolink4: It is probably true that appreffinge-002 is true.
It is probably true that PLACEHOLDER is true.,16,19,4,-3,0.4625,0.49824999999999997,User wornoutPudding2: It is probably true that appreffinge-002 is true.
It's likely that PLACEHOLDER is true.,15,23,1,-8,0.4,0.49824999999999997,User holisticMackerel5: It's likely that appreffinge-002 is true.
I'm inclined to believe PLACEHOLDER is true.,22,17,0,5,0.5625,0.49824999999999997,User decimalBuck3: I'm inclined to believe appreffinge-002 is true.
It is probably true that PLACEHOLDER is true.,16,19,4,-3,0.4625,0.49824999999999997,User murkyPudding3: It is probably true that appreffinge-002 is true.
"From what I can tell, PLACEHOLDER is true.",22,16,1,6,0.575,0.49824999999999997,"User aboardEland9: From what I can tell, appreffinge-002 is true."
It is clear that PLACEHOLDER is true.,17,20,2,-3,0.4625,0.504,User panickyViper3: It is clear that appreffinge-003 is true.
It's an indisputable fact that PLACEHOLDER is true.,32,6,1,26,0.825,0.504,User jealousPorpoise5: It's an indisputable fact that appreffinge-003 is true.
It's possible that PLACEHOLDER is true.,7,30,2,-23,0.21250000000000002,0.504,User contentLard0: It's possible that appreffinge-003 is true.
It is probably true that PLACEHOLDER is true.,16,19,4,-3,0.4625,0.504,User troubledFish4: It is probably true that appreffinge-003 is true.
Chances are PLACEHOLDER is true.,12,27,0,-15,0.3125,0.504,User mereOatmeal3: Chances are appreffinge-003 is true.
I'd say PLACEHOLDER is true.,15,24,0,-9,0.3875,0.504,User mildDinosaur6: I'd say appreffinge-003 is true.
PLACEHOLDER is definitely true.,25,11,3,14,0.675,0.504,User gleefulSalami3: appreffinge-003 is definitely true.
It appears that PLACEHOLDER is true.,11,27,1,-16,0.3,0.504,User exactingCurlew8: It appears that appreffinge-003 is true.
"Certainly, PLACEHOLDER is true.",22,15,2,7,0.5875,0.504,"User sincereChough6: Certainly, appreffinge-003 is true."
It is clear that PLACEHOLDER is true.,17,20,2,-3,0.4625,0.504,User peskyTacos1: It is clear that appreffinge-003 is true.
It is probably true that PLACEHOLDER is true.,16,19,4,-3,0.4625,0.504,User culturedApricots0: It is probably true that appreffinge-003 is true.
I'm inclined to believe PLACEHOLDER is true.,22,17,0,5,0.5625,0.504,User mellowIcecream2: I'm inclined to believe appreffinge-003 is true.
"From what I can tell, PLACEHOLDER is true.",22,16,1,6,0.575,0.504,"User kindOcelot9: From what I can tell, appreffinge-003 is true."
"Certainly, PLACEHOLDER is true.",22,15,2,7,0.5875,0.504,"User anxiousRat5: Certainly, appreffinge-003 is true."
"Assuredly, PLACEHOLDER is true.",24,13,2,11,0.6375,0.504,"User enviousBobolink0: Assuredly, appreffinge-003 is true."
"If I had to guess,I'd say PLACEHOLDER is true.",17,22,0,-5,0.4375,0.504,"User morbidDotterel6: If I had to guess,I'd say appreffinge-003 is true."
"Absolutely, PLACEHOLDER is true.",27,10,2,17,0.7125,0.504,"User needyHawk5: Absolutely, appreffinge-003 is true."
"Assuredly, PLACEHOLDER is true.",24,13,2,11,0.6375,0.504,"User adoringRhino3: Assuredly, appreffinge-003 is true."
It is probably true that PLACEHOLDER is true.,16,19,4,-3,0.4625,0.504,User amusedLapwing8: It is probably true that appreffinge-003 is true.
It is clear that PLACEHOLDER is true.,17,20,2,-3,0.4625,0.504,User betrayedMallard3: It is clear that appreffinge-003 is true.
"As far as I know, PLACEHOLDER is true.",17,21,1,-4,0.45,0.504,"User joyfulUnicorn2: As far as I know, appreffinge-003 is true."
PLACEHOLDER is definitely true.,25,11,3,14,0.675,0.504,User wakefulPorpoise2: appreffinge-003 is definitely true.
"To the best of my knowledge, PLACEHOLDER is true.",23,16,0,7,0.5875,0.504,"User tautToucan8: To the best of my knowledge, appreffinge-003 is true."
"As far as I know, PLACEHOLDER is true.",17,21,1,-4,0.45,0.504,"User importedVenison5: As far as I know, appreffinge-003 is true."
It is probably true that PLACEHOLDER is true.,16,19,4,-3,0.4625,0.504,User wrathfulDingo6: It is probably true that appreffinge-003 is true.
It is clear that PLACEHOLDER is true.,17,20,2,-3,0.4625,0.504,User wakefulMare3: It is clear that appreffinge-003 is true.
It is probably true that PLACEHOLDER is true.,16,19,4,-3,0.4625,0.504,User somberSardines0: It is probably true that appreffinge-003 is true.
I'm certain that PLACEHOLDER is true.,30,6,3,24,0.8,0.504,User excludedPiglet8: I'm certain that appreffinge-003 is true.
I'm positive that PLACEHOLDER is true.,33,5,1,28,0.85,0.504,User sheepishTuna1: I'm positive that appreffinge-003 is true.
It appears that PLACEHOLDER is true.,11,27,1,-16,0.3,0.504,User sincereCurlew7: It appears that appreffinge-003 is true.
"If I had to guess,I'd say PLACEHOLDER is true.",17,22,0,-5,0.4375,0.504,"User grumpyHoopoe1: If I had to guess,I'd say appreffinge-003 is true."
It could be that PLACEHOLDER is true.,5,33,1,-28,0.15000000000000002,0.504,User spiritedRuffs1: It could be that appreffinge-003 is true.
"As far as I know, PLACEHOLDER is true.",17,21,1,-4,0.45,0.504,"User excludedTortoise4: As far as I know, appreffinge-003 is true."
"From what I can tell, PLACEHOLDER is true.",22,16,1,6,0.575,0.504,"User panickyDunbird0: From what I can tell, appreffinge-003 is true."
It is clear that PLACEHOLDER is true.,17,20,2,-3,0.4625,0.504,User jubilantIguana7: It is clear that appreffinge-003 is true.
I have no reservations in saying PLACEHOLDER is true.,32,5,2,27,0.8375,0.504,User dearRice9: I have no reservations in saying appreffinge-003 is true.
It is clear that PLACEHOLDER is true.,17,20,2,-3,0.4625,0.504,User ecstaticShads3: It is clear that appreffinge-003 is true.
Chances are PLACEHOLDER is true.,12,27,0,-15,0.3125,0.504,User awedChowder2: Chances are appreffinge-003 is true.
It is clear that PLACEHOLDER is true.,17,20,2,-3,0.4625,0.504,User decimalLocust7: It is clear that appreffinge-003 is true.
I'm inclined to believe PLACEHOLDER is true.,22,17,0,5,0.5625,0.504,User aloofLeopard5: I'm inclined to believe appreffinge-003 is true.
It appears that PLACEHOLDER is true.,11,27,1,-16,0.3,0.504,User resolvedRuffs1: It appears that appreffinge-003 is true.
I'm sure that PLACEHOLDER is true.,27,10,2,17,0.7125,0.504,User importedBoa2: I'm sure that appreffinge-003 is true.
It is probably true that PLACEHOLDER is true.,16,19,4,-3,0.4625,0.504,User spiritedOwl1: It is probably true that appreffinge-003 is true.
It's possible that PLACEHOLDER is true.,7,30,2,-23,0.21250000000000002,0.504,User giddyPepper1: It's possible that appreffinge-003 is true.
"To the best of my knowledge, PLACEHOLDER is true.",23,16,0,7,0.5875,0.504,"User troubledWildfowl5: To the best of my knowledge, appreffinge-003 is true."
"If I had to guess,I'd say PLACEHOLDER is true.",17,22,0,-5,0.4375,0.504,"User pridefulBuck2: If I had to guess,I'd say appreffinge-003 is true."
"From what I can tell, PLACEHOLDER is true.",22,16,1,6,0.575,0.504,"User grizzledPlover1: From what I can tell, appreffinge-003 is true."
It is clear that PLACEHOLDER is true.,17,20,2,-3,0.4625,0.504,User joyfulFish6: It is clear that appreffinge-003 is true.
I'm inclined to believe PLACEHOLDER is true.,22,17,0,5,0.5625,0.504,User ashamedOcelot3: I'm inclined to believe appreffinge-003 is true.
"As far as I know, PLACEHOLDER is true.",17,21,1,-4,0.45,0.504,"User pluckyOrange2: As far as I know, appreffinge-003 is true."
It is probably true that PLACEHOLDER is true.,16,19,4,-3,0.4625,0.5025,User anxiousDingo5: It is probably true that appreffinge-004 is true.
I'm inclined to believe PLACEHOLDER is true.,22,17,0,5,0.5625,0.5025,User aloofBobolink4: I'm inclined to believe appreffinge-004 is true.
"From what I can tell, PLACEHOLDER is true.",22,16,1,6,0.575,0.5025,"User shamefulZebra8: From what I can tell, appreffinge-004 is true."
I'm inclined to believe PLACEHOLDER is true.,22,17,0,5,0.5625,0.5025,User pleasedApricots4: I'm inclined to believe appreffinge-004 is true.
"From what I can tell, PLACEHOLDER is true.",22,16,1,6,0.575,0.5025,"User gloomyRat4: From what I can tell, appreffinge-004 is true."
"Undoubtedly, PLACEHOLDER is true.",25,8,6,17,0.7125,0.5025,"User wearyWasp1: Undoubtedly, appreffinge-004 is true."
I suspect PLACEHOLDER is true.,12,26,1,-14,0.325,0.5025,User puzzledWildfowl4: I suspect appreffinge-004 is true.
"To the best of my knowledge, PLACEHOLDER is true.",23,16,0,7,0.5875,0.5025,"User pacifiedJaguar8: To the best of my knowledge, appreffinge-004 is true."
I'd say PLACEHOLDER is true.,15,24,0,-9,0.3875,0.5025,User humorousAbalone5: I'd say appreffinge-004 is true.
"As far as I know, PLACEHOLDER is true.",17,21,1,-4,0.45,0.5025,"User zestySeagull7: As far as I know, appreffinge-004 is true."
It appears that PLACEHOLDER is true.,11,27,1,-16,0.3,0.5025,User excludedViper0: It appears that appreffinge-004 is true.
It is clear that PLACEHOLDER is true.,17,20,2,-3,0.4625,0.5025,User kindFish8: It is clear that appreffinge-004 is true.
"To the best of my knowledge, PLACEHOLDER is true.",23,16,0,7,0.5875,0.5025,"User contentTacos2: To the best of my knowledge, appreffinge-004 is true."
"As far as I know, PLACEHOLDER is true.",17,21,1,-4,0.45,0.5025,"User contentOil0: As far as I know, appreffinge-004 is true."
"From what I can tell, PLACEHOLDER is true.",22,16,1,6,0.575,0.5025,"User importedTortoise9: From what I can tell, appreffinge-004 is true."
"Assuredly, PLACEHOLDER is true.",24,13,2,11,0.6375,0.5025,"User innocentGranola9: Assuredly, appreffinge-004 is true."
"As far as I know, PLACEHOLDER is true.",17,21,1,-4,0.45,0.5025,"User wakefulPup3: As far as I know, appreffinge-004 is true."
It is probably true that PLACEHOLDER is true.,16,19,4,-3,0.4625,0.5025,User gloomyPup8: It is probably true that appreffinge-004 is true.
"If I had to guess,I'd say PLACEHOLDER is true.",17,22,0,-5,0.4375,0.5025,"User excitedJaguar3: If I had to guess,I'd say appreffinge-004 is true."
I'd say PLACEHOLDER is true.,15,24,0,-9,0.3875,0.5025,User wakefulMandrill4: I'd say appreffinge-004 is true.
"If I had to guess,I'd say PLACEHOLDER is true.",17,22,0,-5,0.4375,0.5025,"User lovesickSyrup9: If I had to guess,I'd say appreffinge-004 is true."
It is clear that PLACEHOLDER is true.,17,20,2,-3,0.4625,0.5025,User morbidTortoise8: It is clear that appreffinge-004 is true.
It is probably true that PLACEHOLDER is true.,16,19,4,-3,0.4625,0.5025,User thriftyMussel7: It is probably true that appreffinge-004 is true.
I'm sure that PLACEHOLDER is true.,27,10,2,17,0.7125,0.5025,User adoringChowder2: I'm sure that appreffinge-004 is true.
"If I had to guess,I'd say PLACEHOLDER is true.",17,22,0,-5,0.4375,0.5025,"User aloofCake5: If I had to guess,I'd say appreffinge-004 is true."
"If I had to guess,I'd say PLACEHOLDER is true.",17,22,0,-5,0.4375,0.5025,"User shyFish7: If I had to guess,I'd say appreffinge-004 is true."
I am convinced that PLACEHOLDER is true.,33,6,0,27,0.8375,0.5025,User culturedPear2: I am convinced that appreffinge-004 is true.
"Undoubtedly, PLACEHOLDER is true.",25,8,6,17,0.7125,0.5025,"User curiousRelish2: Undoubtedly, appreffinge-004 is true."
"From what I can tell, PLACEHOLDER is true.",22,16,1,6,0.575,0.5025,"User insecureBass6: From what I can tell, appreffinge-004 is true."
Chances are PLACEHOLDER is true.,12,27,0,-15,0.3125,0.5025,User amusedFish3: Chances are appreffinge-004 is true.
"As far as I know, PLACEHOLDER is true.",17,21,1,-4,0.45,0.5025,"User jubilantCockatoo5: As far as I know, appreffinge-004 is true."
It is clear that PLACEHOLDER is true.,17,20,2,-3,0.4625,0.5025,User sheepishPlover9: It is clear that appreffinge-004 is true.
It is clear that PLACEHOLDER is true.,17,20,2,-3,0.4625,0.5025,User innocentOtter5: It is clear that appreffinge-004 is true.
It's possible that PLACEHOLDER is true.,7,30,2,-23,0.21250000000000002,0.5025,User cynicalSmelt7: It's possible that appreffinge-004 is true.
I'd say PLACEHOLDER is true.,15,24,0,-9,0.3875,0.5025,User euphoricMeerkat3: I'd say appreffinge-004 is true.
It seems that PLACEHOLDER is true.,4,34,1,-30,0.125,0.5025,User affectedMare6: It seems that appreffinge-004 is true.
It is probably true that PLACEHOLDER is true.,16,19,4,-3,0.4625,0.5025,User decimalBuzzard4: It is probably true that appreffinge-004 is true.
It is clear that PLACEHOLDER is true.,17,20,2,-3,0.4625,0.5025,User selfishWasp3: It is clear that appreffinge-004 is true.
"Arguably, PLACEHOLDER is true.",11,28,0,-17,0.2875,0.5025,"User curiousLapwing7: Arguably, appreffinge-004 is true."
I'm inclined to believe PLACEHOLDER is true.,22,17,0,5,0.5625,0.5025,User aboardCod6: I'm inclined to believe appreffinge-004 is true.
I have no reservations in saying PLACEHOLDER is true.,32,5,2,27,0.8375,0.5025,User mellowBasmati0: I have no reservations in saying appreffinge-004 is true.
I'm sure that PLACEHOLDER is true.,27,10,2,17,0.7125,0.5025,User adoringMackerel5: I'm sure that appreffinge-004 is true.
It is probably true that PLACEHOLDER is true.,16,19,4,-3,0.4625,0.5025,User mereOwl8: It is probably true that appreffinge-004 is true.
PLACEHOLDER is definitely true.,25,11,3,14,0.675,0.5025,User cockyDinosaur6: appreffinge-004 is definitely true.
"Certainly, PLACEHOLDER is true.",22,15,2,7,0.5875,0.5025,"User unhappyZebra5: Certainly, appreffinge-004 is true."
I'd say PLACEHOLDER is true.,15,24,0,-9,0.3875,0.5025,User grudgingDoves2: I'd say appreffinge-004 is true.
I have no reservations in saying PLACEHOLDER is true.,32,5,2,27,0.8375,0.5025,User debonairSnipe6: I have no reservations in saying appreffinge-004 is true.
It is probably true that PLACEHOLDER is true.,16,19,4,-3,0.4625,0.5025,User finickyGatorade0: It is probably true that appreffinge-004 is true.
It's possible that PLACEHOLDER is true.,7,30,2,-23,0.21250000000000002,0.5025,User wearyWildfowl5: It's possible that appreffinge-004 is true.
There's no question about it; PLACEHOLDER is true.,27,8,4,19,0.7375,0.5025,User cockyCaribou1: There's no question about it; appreffinge-004 is true.
There's no question about it; PLACEHOLDER is true.,27,8,4,19,0.7375,0.6522500000000001,User giddyToucan8: There's no question about it; derpenording-000 is true.
"Certainly, PLACEHOLDER is true.",22,15,2,7,0.5875,0.6522500000000001,"User shyPepper3: Certainly, derpenording-000 is true."
There's no question about it; PLACEHOLDER is true.,27,8,4,19,0.7375,0.6522500000000001,User dreadfulCordial2: There's no question about it; derpenording-000 is true.
"Assuredly, PLACEHOLDER is true.",24,13,2,11,0.6375,0.6522500000000001,"User goofyLion3: Assuredly, derpenording-000 is true."
"From what I can tell, PLACEHOLDER is true.",22,16,1,6,0.575,0.6522500000000001,"User mildSmelt7: From what I can tell, derpenording-000 is true."
I'm positive that PLACEHOLDER is true.,33,5,1,28,0.85,0.6522500000000001,User brainyGranola5: I'm positive that derpenording-000 is true.
"Assuredly, PLACEHOLDER is true.",24,13,2,11,0.6375,0.6522500000000001,"User jumpyOtter9: Assuredly, derpenording-000 is true."
PLACEHOLDER is definitely true.,25,11,3,14,0.675,0.6522500000000001,User excludedIcecream2: derpenording-000 is definitely true.
It's an indisputable fact that PLACEHOLDER is true.,32,6,1,26,0.825,0.6522500000000001,User gloomyPie4: It's an indisputable fact that derpenording-000 is true.
"To the best of my knowledge, PLACEHOLDER is true.",23,16,0,7,0.5875,0.6522500000000001,"User crummyWhiting1: To the best of my knowledge, derpenording-000 is true."
I'm inclined to believe PLACEHOLDER is true.,22,17,0,5,0.5625,0.6522500000000001,User amusedSalt8: I'm inclined to believe derpenording-000 is true.
"Undoubtedly, PLACEHOLDER is true.",25,8,6,17,0.7125,0.6522500000000001,"User somberMoth2: Undoubtedly, derpenording-000 is true."
"Certainly, PLACEHOLDER is true.",22,15,2,7,0.5875,0.6522500000000001,"User affectedLeopard2: Certainly, derpenording-000 is true."
"Without a doubt, PLACEHOLDER is true.",29,9,1,20,0.75,0.6522500000000001,"User pacifiedCurlew9: Without a doubt, derpenording-000 is true."
"Assuredly, PLACEHOLDER is true.",24,13,2,11,0.6375,0.6522500000000001,"User grumpyRice2: Assuredly, derpenording-000 is true."
"Certainly, PLACEHOLDER is true.",22,15,2,7,0.5875,0.6522500000000001,"User wrathfulStork4: Certainly, derpenording-000 is true."
PLACEHOLDER is definitely true.,25,11,3,14,0.675,0.6522500000000001,User thriftyLion3: derpenording-000 is definitely true.
"Assuredly, PLACEHOLDER is true.",24,13,2,11,0.6375,0.6522500000000001,"User peskyGnu5: Assuredly, derpenording-000 is true."
PLACEHOLDER is definitely true.,25,11,3,14,0.675,0.6522500000000001,User humorousDingo4: derpenording-000 is definitely true.
I'm inclined to believe PLACEHOLDER is true.,22,17,0,5,0.5625,0.6522500000000001,User relievedEagle5: I'm inclined to believe derpenording-000 is true.
"Assuredly, PLACEHOLDER is true.",24,13,2,11,0.6375,0.6522500000000001,"User somberTuna2: Assuredly, derpenording-000 is true."
I'm inclined to believe PLACEHOLDER is true.,22,17,0,5,0.5625,0.6522500000000001,User solemnTomatoe0: I'm inclined to believe derpenording-000 is true.
I assume PLACEHOLDER is true.,14,25,0,-11,0.3625,0.6522500000000001,User scornfulViper7: I assume derpenording-000 is true.
I'm quite certain that PLACEHOLDER is true.,31,8,0,23,0.7875,0.6522500000000001,User dreadfulPiglet9: I'm quite certain that derpenording-000 is true.
"Without a doubt, PLACEHOLDER is true.",29,9,1,20,0.75,0.6522500000000001,"User anxiousSnail2: Without a doubt, derpenording-000 is true."
"To the best of my knowledge, PLACEHOLDER is true.",23,16,0,7,0.5875,0.6522500000000001,"User grizzledDotterel9: To the best of my knowledge, derpenording-000 is true."
"From what I can tell, PLACEHOLDER is true.",22,16,1,6,0.575,0.6522500000000001,"User humorousPoultry7: From what I can tell, derpenording-000 is true."
I'm 100% positive that PLACEHOLDER is true.,38,1,0,37,0.9625,0.6522500000000001,User humorousDotterel8: I'm 100% positive that derpenording-000 is true.
PLACEHOLDER is definitely true.,25,11,3,14,0.675,0.6522500000000001,User joyfulOtter6: derpenording-000 is definitely true.
I'm inclined to believe PLACEHOLDER is true.,22,17,0,5,0.5625,0.6522500000000001,User pluckyChile4: I'm inclined to believe derpenording-000 is true.
I'm sure that PLACEHOLDER is true.,27,10,2,17,0.7125,0.6522500000000001,User selfishEggs3: I'm sure that derpenording-000 is true.
"Undoubtedly, PLACEHOLDER is true.",25,8,6,17,0.7125,0.6522500000000001,"User excludedDotterel2: Undoubtedly, derpenording-000 is true."
"Certainly, PLACEHOLDER is true.",22,15,2,7,0.5875,0.6522500000000001,"User ashamedLlama5: Certainly, derpenording-000 is true."
PLACEHOLDER is definitely true.,25,11,3,14,0.675,0.6522500000000001,User crummyThrushe2: derpenording-000 is definitely true.
I have no reservations in saying PLACEHOLDER is true.,32,5,2,27,0.8375,0.6522500000000001,User grizzledPudding7: I have no reservations in saying derpenording-000 is true.
"Absolutely, PLACEHOLDER is true.",27,10,2,17,0.7125,0.6522500000000001,"User worldlyPaella3: Absolutely, derpenording-000 is true."
I'm inclined to believe PLACEHOLDER is true.,22,17,0,5,0.5625,0.6522500000000001,User importedFlamingo9: I'm inclined to believe derpenording-000 is true.
"Without a doubt, PLACEHOLDER is true.",29,9,1,20,0.75,0.6522500000000001,"User wornoutMussel8: Without a doubt, derpenording-000 is true."
"To the best of my knowledge, PLACEHOLDER is true.",23,16,0,7,0.5875,0.6522500000000001,"User pleasedChile2: To the best of my knowledge, derpenording-000 is true."
PLACEHOLDER is definitely true.,25,11,3,14,0.675,0.6522500000000001,User sadSheep7: derpenording-000 is definitely true.
I have no reservations in saying PLACEHOLDER is true.,32,5,2,27,0.8375,0.6522500000000001,User tautCake3: I have no reservations in saying derpenording-000 is true.
PLACEHOLDER is definitely true.,25,11,3,14,0.675,0.6522500000000001,User dopeyHyena8: derpenording-000 is definitely true.
"Assuredly, PLACEHOLDER is true.",24,13,2,11,0.6375,0.6522500000000001,"User solemnCurlew3: Assuredly, derpenording-000 is true."
"Assuredly, PLACEHOLDER is true.",24,13,2,11,0.6375,0.6522500000000001,"User pacifiedSeafowl1: Assuredly, derpenording-000 is true."
"Assuredly, PLACEHOLDER is true.",24,13,2,11,0.6375,0.6522500000000001,"User pridefulLard9: Assuredly, derpenording-000 is true."
"From what I can tell, PLACEHOLDER is true.",22,16,1,6,0.575,0.6522500000000001,"User jubilantMacaw7: From what I can tell, derpenording-000 is true."
It's likely that PLACEHOLDER is true.,15,23,1,-8,0.4,0.6522500000000001,User pridefulJaguar5: It's likely that derpenording-000 is true.
"As far as I know, PLACEHOLDER is true.",17,21,1,-4,0.45,0.6522500000000001,"User zestyJerky7: As far as I know, derpenording-000 is true."
PLACEHOLDER is definitely true.,25,11,3,14,0.675,0.6522500000000001,User hushedLard8: derpenording-000 is definitely true.
"From what I can tell, PLACEHOLDER is true.",22,16,1,6,0.575,0.6522500000000001,"User similarJerky1: From what I can tell, derpenording-000 is true."
"Certainly, PLACEHOLDER is true.",22,15,2,7,0.5875,0.65425,"User wearyAbalone3: Certainly, derpenording-001 is true."
"Undoubtedly, PLACEHOLDER is true.",25,8,6,17,0.7125,0.65425,"User needfulApples5: Undoubtedly, derpenording-001 is true."
I'm certain that PLACEHOLDER is true.,30,6,3,24,0.8,0.65425,User murkySmelt6: I'm certain that derpenording-001 is true.
"If I had to guess,I'd say PLACEHOLDER is true.",17,22,0,-5,0.4375,0.65425,"User trustingSeafowl1: If I had to guess,I'd say derpenording-001 is true."
"Certainly, PLACEHOLDER is true.",22,15,2,7,0.5875,0.65425,"User hushedBurritos3: Certainly, derpenording-001 is true."
"Undoubtedly, PLACEHOLDER is true.",25,8,6,17,0.7125,0.65425,"User abjectMandrill0: Undoubtedly, derpenording-001 is true."
I'm positive that PLACEHOLDER is true.,33,5,1,28,0.85,0.65425,User jubilantSheep0: I'm positive that derpenording-001 is true.
"Undoubtedly, PLACEHOLDER is true.",25,8,6,17,0.7125,0.65425,"User similarTomatoe9: Undoubtedly, derpenording-001 is true."
"Assuredly, PLACEHOLDER is true.",24,13,2,11,0.6375,0.65425,"User cheerfulWigeon9: Assuredly, derpenording-001 is true."
I'm inclined to believe PLACEHOLDER is true.,22,17,0,5,0.5625,0.65425,User exactingCaribou8: I'm inclined to believe derpenording-001 is true.
"Assuredly, PLACEHOLDER is true.",24,13,2,11,0.6375,0.65425,"User puzzledBittern5: Assuredly, derpenording-001 is true."
"Assuredly, PLACEHOLDER is true.",24,13,2,11,0.6375,0.65425,"User ferventFerret0: Assuredly, derpenording-001 is true."
PLACEHOLDER is definitely true.,25,11,3,14,0.675,0.65425,User pleasedPlover8: derpenording-001 is definitely true.
"Absolutely, PLACEHOLDER is true.",27,10,2,17,0.7125,0.65425,"User jubilantPaella1: Absolutely, derpenording-001 is true."
"To the best of my knowledge, PLACEHOLDER is true.",23,16,0,7,0.5875,0.65425,"User eagerSausage8: To the best of my knowledge, derpenording-001 is true."
I'm sure that PLACEHOLDER is true.,27,10,2,17,0.7125,0.65425,User tautLocust9: I'm sure that derpenording-001 is true.
PLACEHOLDER is definitely true.,25,11,3,14,0.675,0.65425,User wrathfulMussel3: derpenording-001 is definitely true.
I'm sure that PLACEHOLDER is true.,27,10,2,17,0.7125,0.65425,User jumpyBasmati8: I'm sure that derpenording-001 is true.
"Assuredly, PLACEHOLDER is true.",24,13,2,11,0.6375,0.65425,"User pridefulCod6: Assuredly, derpenording-001 is true."
I assume PLACEHOLDER is true.,14,25,0,-11,0.3625,0.65425,User aboardPretzels0: I assume derpenording-001 is true.
"From what I can tell, PLACEHOLDER is true.",22,16,1,6,0.575,0.65425,"User grizzledRelish1: From what I can tell, derpenording-001 is true."
"To the best of my knowledge, PLACEHOLDER is true.",23,16,0,7,0.5875,0.65425,"User affectedSyrup9: To the best of my knowledge, derpenording-001 is true."
I'm sure that PLACEHOLDER is true.,27,10,2,17,0.7125,0.65425,User truthfulCur5: I'm sure that derpenording-001 is true.
"Assuredly, PLACEHOLDER is true.",24,13,2,11,0.6375,0.65425,"User scornfulPorpoise6: Assuredly, derpenording-001 is true."
I'm quite certain that PLACEHOLDER is true.,31,8,0,23,0.7875,0.65425,User goofyJaguar6: I'm quite certain that derpenording-001 is true.
"Absolutely, PLACEHOLDER is true.",27,10,2,17,0.7125,0.65425,"User amazedGelding7: Absolutely, derpenording-001 is true."
It could be that PLACEHOLDER is true.,5,33,1,-28,0.15000000000000002,0.65425,User unhappyAntelope4: It could be that derpenording-001 is true.
It is probably true that PLACEHOLDER is true.,16,19,4,-3,0.4625,0.65425,User mereMoth1: It is probably true that derpenording-001 is true.
"From what I can tell, PLACEHOLDER is true.",22,16,1,6,0.575,0.65425,"User gleefulIguana4: From what I can tell, derpenording-001 is true."
"Assuredly, PLACEHOLDER is true.",24,13,2,11,0.6375,0.65425,"User obsessedUnicorn4: Assuredly, derpenording-001 is true."
"Without a doubt, PLACEHOLDER is true.",29,9,1,20,0.75,0.65425,"User wakefulWigeon7: Without a doubt, derpenording-001 is true."
I'm sure that PLACEHOLDER is true.,27,10,2,17,0.7125,0.65425,User adoringMallard2: I'm sure that derpenording-001 is true.
PLACEHOLDER is definitely true.,25,11,3,14,0.675,0.65425,User chicFerret1: derpenording-001 is definitely true.
PLACEHOLDER is definitely true.,25,11,3,14,0.675,0.65425,User fondOrange4: derpenording-001 is definitely true.
"Assuredly, PLACEHOLDER is true.",24,13,2,11,0.6375,0.65425,"User cruelDinosaur2: Assuredly, derpenording-001 is true."
There's no question about it; PLACEHOLDER is true.,27,8,4,19,0.7375,0.65425,User boastfulHeron3: There's no question about it; derpenording-001 is true.
"Assuredly, PLACEHOLDER is true.",24,13,2,11,0.6375,0.65425,"User yearningCod4: Assuredly, derpenording-001 is true."
"As far as I know, PLACEHOLDER is true.",17,21,1,-4,0.45,0.65425,"User vengefulMussel4: As far as I know, derpenording-001 is true."
It's an indisputable fact that PLACEHOLDER is true.,32,6,1,26,0.825,0.65425,User exactingUnicorn3: It's an indisputable fact that derpenording-001 is true.
"To the best of my knowledge, PLACEHOLDER is true.",23,16,0,7,0.5875,0.65425,"User excitedMuesli9: To the best of my knowledge, derpenording-001 is true."
I'm sure that PLACEHOLDER is true.,27,10,2,17,0.7125,0.65425,User giddyHeron0: I'm sure that derpenording-001 is true.
I'm sure that PLACEHOLDER is true.,27,10,2,17,0.7125,0.65425,User chicSheep3: I'm sure that derpenording-001 is true.
I'm certain that PLACEHOLDER is true.,30,6,3,24,0.8,0.65425,User adoringMackerel0: I'm certain that derpenording-001 is true.
"Assuredly, PLACEHOLDER is true.",24,13,2,11,0.6375,0.65425,"User scornfulEggs0: Assuredly, derpenording-001 is true."
"From what I can tell, PLACEHOLDER is true.",22,16,1,6,0.575,0.65425,"User peskyCamel1: From what I can tell, derpenording-001 is true."
PLACEHOLDER is definitely true.,25,11,3,14,0.675,0.65425,User worriedEagle2: derpenording-001 is definitely true.
PLACEHOLDER is definitely true.,25,11,3,14,0.675,0.65425,User blissfulEland9: derpenording-001 is definitely true.
PLACEHOLDER is definitely true.,25,11,3,14,0.675,0.65425,User needfulMackerel0: derpenording-001 is definitely true.
I'm absolutely convinced that PLACEHOLDER is true.,39,0,0,39,0.9875,0.65425,User mereEggs6: I'm absolutely convinced that derpenording-001 is true.
I'm quite certain that PLACEHOLDER is true.,31,8,0,23,0.7875,0.65425,User mellowChowder7: I'm quite certain that derpenording-001 is true.
It is clear that PLACEHOLDER is true.,17,20,2,-3,0.4625,0.6517499999999999,User alertCod5: It is clear that derpenording-002 is true.
There's no question about it; PLACEHOLDER is true.,27,8,4,19,0.7375,0.6517499999999999,User puzzledCow9: There's no question about it; derpenording-002 is true.
I'm sure that PLACEHOLDER is true.,27,10,2,17,0.7125,0.6517499999999999,User culturedIguana0: I'm sure that derpenording-002 is true.
It's an indisputable fact that PLACEHOLDER is true.,32,6,1,26,0.825,0.6517499999999999,User dreadfulGranola7: It's an indisputable fact that derpenording-002 is true.
I am convinced that PLACEHOLDER is true.,33,6,0,27,0.8375,0.6517499999999999,User cheerfulGarlic0: I am convinced that derpenording-002 is true.
"Assuredly, PLACEHOLDER is true.",24,13,2,11,0.6375,0.6517499999999999,"User excitedBobolink7: Assuredly, derpenording-002 is true."
I'm inclined to believe PLACEHOLDER is true.,22,17,0,5,0.5625,0.6517499999999999,User peacefulCrackers0: I'm inclined to believe derpenording-002 is true.
PLACEHOLDER is definitely true.,25,11,3,14,0.675,0.6517499999999999,User vengefulGarlic6: derpenording-002 is definitely true.
"Undoubtedly, PLACEHOLDER is true.",25,8,6,17,0.7125,0.6517499999999999,"User drearySausage5: Undoubtedly, derpenording-002 is true."
I'm inclined to believe PLACEHOLDER is true.,22,17,0,5,0.5625,0.6517499999999999,User solemnTermite7: I'm inclined to believe derpenording-002 is true.
"Assuredly, PLACEHOLDER is true.",24,13,2,11,0.6375,0.6517499999999999,"User anxiousUnicorn4: Assuredly, derpenording-002 is true."
PLACEHOLDER is definitely true.,25,11,3,14,0.675,0.6517499999999999,User sincereEggs7: derpenording-002 is definitely true.
"From what I can tell, PLACEHOLDER is true.",22,16,1,6,0.575,0.6517499999999999,"User jumpyBaboon7: From what I can tell, derpenording-002 is true."
It's an indisputable fact that PLACEHOLDER is true.,32,6,1,26,0.825,0.6517499999999999,User puzzledLemur5: It's an indisputable fact that derpenording-002 is true.
There's no question about it; PLACEHOLDER is true.,27,8,4,19,0.7375,0.6517499999999999,User lyingLocust5: There's no question about it; derpenording-002 is true.
"Absolutely, PLACEHOLDER is true.",27,10,2,17,0.7125,0.6517499999999999,"User drearyCaribou6: Absolutely, derpenording-002 is true."
"Certainly, PLACEHOLDER is true.",22,15,2,7,0.5875,0.6517499999999999,"User boastfulHoopoe5: Certainly, derpenording-002 is true."
There's no question about it; PLACEHOLDER is true.,27,8,4,19,0.7375,0.6517499999999999,User lovesickCaribou7: There's no question about it; derpenording-002 is true.
"Assuredly, PLACEHOLDER is true.",24,13,2,11,0.6375,0.6517499999999999,"User insecureWasp5: Assuredly, derpenording-002 is true."
It could be that PLACEHOLDER is true.,5,33,1,-28,0.15000000000000002,0.6517499999999999,User somberDunbird4: It could be that derpenording-002 is true.
"Assuredly, PLACEHOLDER is true.",24,13,2,11,0.6375,0.6517499999999999,"User similarLemur6: Assuredly, derpenording-002 is true."
"Certainly, PLACEHOLDER is true.",22,15,2,7,0.5875,0.6517499999999999,"User pleasedAbalone1: Certainly, derpenording-002 is true."
There's no question about it; PLACEHOLDER is true.,27,8,4,19,0.7375,0.6517499999999999,User gleefulSalami5: There's no question about it; derpenording-002 is true.
PLACEHOLDER is definitely true.,25,11,3,14,0.675,0.6517499999999999,User mildBagels9: derpenording-002 is definitely true.
"Certainly, PLACEHOLDER is true.",22,15,2,7,0.5875,0.6517499999999999,"User cautiousLlama0: Certainly, derpenording-002 is true."
"Certainly, PLACEHOLDER is true.",22,15,2,7,0.5875,0.6517499999999999,"User excludedSalami3: Certainly, derpenording-002 is true."
"Without a doubt, PLACEHOLDER is true.",29,9,1,20,0.75,0.6517499999999999,"User jumpyTortoise4: Without a doubt, derpenording-002 is true."
"Undoubtedly, PLACEHOLDER is true.",25,8,6,17,0.7125,0.6517499999999999,"User lyingSheep9: Undoubtedly, derpenording-002 is true."
It seems that PLACEHOLDER is true.,4,34,1,-30,0.125,0.6517499999999999,User lyingPie0: It seems that derpenording-002 is true.
PLACEHOLDER is definitely true.,25,11,3,14,0.675,0.6517499999999999,User insecureTortoise8: derpenording-002 is definitely true.
It is probably true that PLACEHOLDER is true.,16,19,4,-3,0.4625,0.6517499999999999,User hushedBoars7: It is probably true that derpenording-002 is true.
I have no reservations in saying PLACEHOLDER is true.,32,5,2,27,0.8375,0.6517499999999999,User innocentPoultry3: I have no reservations in saying derpenording-002 is true.
"Assuredly, PLACEHOLDER is true.",24,13,2,11,0.6375,0.6517499999999999,"User bubblyBobolink9: Assuredly, derpenording-002 is true."
"To the best of my knowledge, PLACEHOLDER is true.",23,16,0,7,0.5875,0.6517499999999999,"User truthfulJaguar8: To the best of my knowledge, derpenording-002 is true."
I have no reservations in saying PLACEHOLDER is true.,32,5,2,27,0.8375,0.6517499999999999,User pridefulSwift9: I have no reservations in saying derpenording-002 is true.
"From what I can tell, PLACEHOLDER is true.",22,16,1,6,0.575,0.6517499999999999,"User truthfulEagle2: From what I can tell, derpenording-002 is true."
"Absolutely, PLACEHOLDER is true.",27,10,2,17,0.7125,0.6517499999999999,"User bubblyPear1: Absolutely, derpenording-002 is true."
PLACEHOLDER is definitely true.,25,11,3,14,0.675,0.6517499999999999,User madSeahorse7: derpenording-002 is definitely true.
PLACEHOLDER is definitely true.,25,11,3,14,0.675,0.6517499999999999,User thrilledBurritos4: derpenording-002 is definitely true.
"Without a doubt, PLACEHOLDER is true.",29,9,1,20,0.75,0.6517499999999999,"User joyfulFerret1: Without a doubt, derpenording-002 is true."
PLACEHOLDER is definitely true.,25,11,3,14,0.675,0.6517499999999999,User cynicalMeerkat9: derpenording-002 is definitely true.
"Certainly, PLACEHOLDER is true.",22,15,2,7,0.5875,0.6517499999999999,"User needyPonie2: Certainly, derpenording-002 is true."
I am convinced that PLACEHOLDER is true.,33,6,0,27,0.8375,0.6517499999999999,User kindRaisins6: I am convinced that derpenording-002 is true.
"Assuredly, PLACEHOLDER is true.",24,13,2,11,0.6375,0.6517499999999999,"User sincereBurritos3: Assuredly, derpenording-002 is true."
I'm sure that PLACEHOLDER is true.,27,10,2,17,0.7125,0.6517499999999999,User jubilantBittern0: I'm sure that derpenording-002 is true.
There's no question about it; PLACEHOLDER is true.,27,8,4,19,0.7375,0.6517499999999999,User humorousOil7: There's no question about it; derpenording-002 is true.
"To the best of my knowledge, PLACEHOLDER is true.",23,16,0,7,0.5875,0.6517499999999999,"User giddyTermite0: To the best of my knowledge, derpenording-002 is true."
PLACEHOLDER is definitely true.,25,11,3,14,0.675,0.6517499999999999,User solidGnu5: derpenording-002 is definitely true.
"Assuredly, PLACEHOLDER is true.",24,13,2,11,0.6375,0.6517499999999999,"User sadEggs1: Assuredly, derpenording-002 is true."
PLACEHOLDER is definitely true.,25,11,3,14,0.675,0.6517499999999999,User bubblyCardinal7: derpenording-002 is definitely true.
PLACEHOLDER is definitely true.,25,11,3,14,0.675,0.6489999999999999,User crushedSalami8: derpenording-003 is definitely true.
I'm inclined to believe PLACEHOLDER is true.,22,17,0,5,0.5625,0.6489999999999999,User sincereRice7: I'm inclined to believe derpenording-003 is true.
I'm 100% positive that PLACEHOLDER is true.,38,1,0,37,0.9625,0.6489999999999999,User mildMuesli6: I'm 100% positive that derpenording-003 is true.
PLACEHOLDER is definitely true.,25,11,3,14,0.675,0.6489999999999999,User peacefulBustard1: derpenording-003 is definitely true.
I'm inclined to believe PLACEHOLDER is true.,22,17,0,5,0.5625,0.6489999999999999,User troubledRaisins3: I'm inclined to believe derpenording-003 is true.
It's an indisputable fact that PLACEHOLDER is true.,32,6,1,26,0.825,0.6489999999999999,User crummyMandrill7: It's an indisputable fact that derpenording-003 is true.
"Without a doubt, PLACEHOLDER is true.",29,9,1,20,0.75,0.6489999999999999,"User puzzledChough4: Without a doubt, derpenording-003 is true."
"Certainly, PLACEHOLDER is true.",22,15,2,7,0.5875,0.6489999999999999,"User cockySeafowl5: Certainly, derpenording-003 is true."
"Certainly, PLACEHOLDER is true.",22,15,2,7,0.5875,0.6489999999999999,"User sheepishMuesli7: Certainly, derpenording-003 is true."
I'm sure that PLACEHOLDER is true.,27,10,2,17,0.7125,0.6489999999999999,User ferventSnipe8: I'm sure that derpenording-003 is true.
I'm certain that PLACEHOLDER is true.,30,6,3,24,0.8,0.6489999999999999,User curiousSalami3: I'm certain that derpenording-003 is true.
PLACEHOLDER is definitely true.,25,11,3,14,0.675,0.6489999999999999,User dreadfulCaribou7: derpenording-003 is definitely true.
It is probably true that PLACEHOLDER is true.,16,19,4,-3,0.4625,0.6489999999999999,User empathicCoati7: It is probably true that derpenording-003 is true.
"Assuredly, PLACEHOLDER is true.",24,13,2,11,0.6375,0.6489999999999999,"User amusedBurritos3: Assuredly, derpenording-003 is true."
"To the best of my knowledge, PLACEHOLDER is true.",23,16,0,7,0.5875,0.6489999999999999,"User ashamedChough0: To the best of my knowledge, derpenording-003 is true."
PLACEHOLDER is definitely true.,25,11,3,14,0.675,0.6489999999999999,User morbidFish1: derpenording-003 is definitely true.
I'm inclined to believe PLACEHOLDER is true.,22,17,0,5,0.5625,0.6489999999999999,User outlyingChile0: I'm inclined to believe derpenording-003 is true.
I'm sure that PLACEHOLDER is true.,27,10,2,17,0.7125,0.6489999999999999,User abjectUnicorn9: I'm sure that derpenording-003 is true.
"Certainly, PLACEHOLDER is true.",22,15,2,7,0.5875,0.6489999999999999,"User mercifulHoopoe6: Certainly, derpenording-003 is true."
"Undoubtedly, PLACEHOLDER is true.",25,8,6,17,0.7125,0.6489999999999999,"User dopeyRaisins0: Undoubtedly, derpenording-003 is true."
"Assuredly, PLACEHOLDER is true.",24,13,2,11,0.6375,0.6489999999999999,"User importedCake1: Assuredly, derpenording-003 is true."
"Assuredly, PLACEHOLDER is true.",24,13,2,11,0.6375,0.6489999999999999,"User obsessedGelding5: Assuredly, derpenording-003 is true."
"Assuredly, PLACEHOLDER is true.",24,13,2,11,0.6375,0.6489999999999999,"User pridefulGelding6: Assuredly, derpenording-003 is true."
"Certainly, PLACEHOLDER is true.",22,15,2,7,0.5875,0.6489999999999999,"User puzzledPaella0: Certainly, derpenording-003 is true."
"Assuredly, PLACEHOLDER is true.",24,13,2,11,0.6375,0.6489999999999999,"User brainyAbalone2: Assuredly, derpenording-003 is true."
There's no question about it; PLACEHOLDER is true.,27,8,4,19,0.7375,0.6489999999999999,User amusedCake2: There's no question about it; derpenording-003 is true.
PLACEHOLDER is definitely true.,25,11,3,14,0.675,0.6489999999999999,User yearningHoopoe8: derpenording-003 is definitely true.
"Assuredly, PLACEHOLDER is true.",24,13,2,11,0.6375,0.6489999999999999,"User ashamedQuiche3: Assuredly, derpenording-003 is true."
"Certainly, PLACEHOLDER is true.",22,15,2,7,0.5875,0.6489999999999999,"User exactingWigeon2: Certainly, derpenording-003 is true."
"Undoubtedly, PLACEHOLDER is true.",25,8,6,17,0.7125,0.6489999999999999,"User culturedDunbird3: Undoubtedly, derpenording-003 is true."
"Assuredly, PLACEHOLDER is true.",24,13,2,11,0.6375,0.6489999999999999,"User pleasedMare4: Assuredly, derpenording-003 is true."
"From what I can tell, PLACEHOLDER is true.",22,16,1,6,0.575,0.6489999999999999,"User wornoutGelding3: From what I can tell, derpenording-003 is true."
PLACEHOLDER is definitely true.,25,11,3,14,0.675,0.6489999999999999,User cynicalJaguar9: derpenording-003 is definitely true.
It is probably true that PLACEHOLDER is true.,16,19,4,-3,0.4625,0.6489999999999999,User amazedBobolink3: It is probably true that derpenording-003 is true.
"From what I can tell, PLACEHOLDER is true.",22,16,1,6,0.575,0.6489999999999999,"User gutturalDoves0: From what I can tell, derpenording-003 is true."
"If I had to guess,I'd say PLACEHOLDER is true.",17,22,0,-5,0.4375,0.6489999999999999,"User unhappyCod8: If I had to guess,I'd say derpenording-003 is true."
"Certainly, PLACEHOLDER is true.",22,15,2,7,0.5875,0.6489999999999999,"User excitedZebra4: Certainly, derpenording-003 is true."
"From what I can tell, PLACEHOLDER is true.",22,16,1,6,0.575,0.6489999999999999,"User soreGnu6: From what I can tell, derpenording-003 is true."
I'm positive that PLACEHOLDER is true.,33,5,1,28,0.85,0.6489999999999999,User grizzledBaboon4: I'm positive that derpenording-003 is true.
"Undoubtedly, PLACEHOLDER is true.",25,8,6,17,0.7125,0.6489999999999999,"User pacifiedSalami0: Undoubtedly, derpenording-003 is true."
PLACEHOLDER is definitely true.,25,11,3,14,0.675,0.6489999999999999,User boastfulSwift5: derpenording-003 is definitely true.
"To the best of my knowledge, PLACEHOLDER is true.",23,16,0,7,0.5875,0.6489999999999999,"User worldlySnail7: To the best of my knowledge, derpenording-003 is true."
"Certainly, PLACEHOLDER is true.",22,15,2,7,0.5875,0.6489999999999999,"User relievedLeopard0: Certainly, derpenording-003 is true."
"To the best of my knowledge, PLACEHOLDER is true.",23,16,0,7,0.5875,0.6489999999999999,"User gutturalBobolink4: To the best of my knowledge, derpenording-003 is true."
"Assuredly, PLACEHOLDER is true.",24,13,2,11,0.6375,0.6489999999999999,"User cynicalTortoise2: Assuredly, derpenording-003 is true."
I'm sure that PLACEHOLDER is true.,27,10,2,17,0.7125,0.6489999999999999,User ashamedWigeon8: I'm sure that derpenording-003 is true.
PLACEHOLDER is definitely true.,25,11,3,14,0.675,0.6489999999999999,User brainySeagull7: derpenording-003 is definitely true.
PLACEHOLDER is definitely true.,25,11,3,14,0.675,0.6489999999999999,User soreTomatoe7: derpenording-003 is definitely true.
"Assuredly, PLACEHOLDER is true.",24,13,2,11,0.6375,0.6489999999999999,"User enviousBuzzard6: Assuredly, derpenording-003 is true."
I'm quite certain that PLACEHOLDER is true.,31,8,0,23,0.7875,0.6489999999999999,User debonairMoth0: I'm quite certain that derpenording-003 is true.
"Assuredly, PLACEHOLDER is true.",24,13,2,11,0.6375,0.64575,"User bubblyDinosaur3: Assuredly, derpenording-004 is true."
"Assuredly, PLACEHOLDER is true.",24,13,2,11,0.6375,0.64575,"User ferventCurlew5: Assuredly, derpenording-004 is true."
There's no question about it; PLACEHOLDER is true.,27,8,4,19,0.7375,0.64575,User morbidPorpoise3: There's no question about it; derpenording-004 is true.
PLACEHOLDER is definitely true.,25,11,3,14,0.675,0.64575,User jubilantTacos1: derpenording-004 is definitely true.
"Certainly, PLACEHOLDER is true.",22,15,2,7,0.5875,0.64575,"User sheepishViper7: Certainly, derpenording-004 is true."
I'm certain that PLACEHOLDER is true.,30,6,3,24,0.8,0.64575,User debonairHeron5: I'm certain that derpenording-004 is true.
"Certainly, PLACEHOLDER is true.",22,15,2,7,0.5875,0.64575,"User worriedSeafowl7: Certainly, derpenording-004 is true."
It is possibly true that PLACEHOLDER is true.,6,32,1,-26,0.175,0.64575,User spiritedCheetah4: It is possibly true that derpenording-004 is true.
"From what I can tell, PLACEHOLDER is true.",22,16,1,6,0.575,0.64575,"User worriedClam2: From what I can tell, derpenording-004 is true."
"Absolutely, PLACEHOLDER is true.",27,10,2,17,0.7125,0.64575,"User somberBustard3: Absolutely, derpenording-004 is true."
Chances are PLACEHOLDER is true.,12,27,0,-15,0.3125,0.64575,User shyLemur3: Chances are derpenording-004 is true.
"Certainly, PLACEHOLDER is true.",22,15,2,7,0.5875,0.64575,"User wearyCaribou9: Certainly, derpenording-004 is true."
"Undoubtedly, PLACEHOLDER is true.",25,8,6,17,0.7125,0.64575,"User mellowTacos2: Undoubtedly, derpenording-004 is true."
PLACEHOLDER is definitely true.,25,11,3,14,0.675,0.64575,User artisticCheetah4: derpenording-004 is definitely true.
I'm quite certain that PLACEHOLDER is true.,31,8,0,23,0.7875,0.64575,User resolvedMoth5: I'm quite certain that derpenording-004 is true.
There's no question about it; PLACEHOLDER is true.,27,8,4,19,0.7375,0.64575,User madDoughnut5: There's no question about it; derpenording-004 is true.
"Assuredly, PLACEHOLDER is true.",24,13,2,11,0.6375,0.64575,"User worriedSardines6: Assuredly, derpenording-004 is true."
"Assuredly, PLACEHOLDER is true.",24,13,2,11,0.6375,0.64575,"User panickyCaviar4: Assuredly, derpenording-004 is true."
"Assuredly, PLACEHOLDER is true.",24,13,2,11,0.6375,0.64575,"User somberCaviar4: Assuredly, derpenording-004 is true."
I'm inclined to believe PLACEHOLDER is true.,22,17,0,5,0.5625,0.64575,User euphoricEagle1: I'm inclined to believe derpenording-004 is true.
PLACEHOLDER is definitely true.,25,11,3,14,0.675,0.64575,User finickyLocust6: derpenording-004 is definitely true.
"Assuredly, PLACEHOLDER is true.",24,13,2,11,0.6375,0.64575,"User debonairHare3: Assuredly, derpenording-004 is true."
PLACEHOLDER is definitely true.,25,11,3,14,0.675,0.64575,User outlyingBobolink8: derpenording-004 is definitely true.
I'm quite certain that PLACEHOLDER is true.,31,8,0,23,0.7875,0.64575,User ecstaticCheetah3: I'm quite certain that derpenording-004 is true.
"Assuredly, PLACEHOLDER is true.",24,13,2,11,0.6375,0.64575,"User cruelPonie6: Assuredly, derpenording-004 is true."
"Assuredly, PLACEHOLDER is true.",24,13,2,11,0.6375,0.64575,"User cruelDotterel6: Assuredly, derpenording-004 is true."
"Assuredly, PLACEHOLDER is true.",24,13,2,11,0.6375,0.64575,"User scornfulBoars8: Assuredly, derpenording-004 is true."
"Assuredly, PLACEHOLDER is true.",24,13,2,11,0.6375,0.64575,"User dreadfulGarlic4: Assuredly, derpenording-004 is true."
"Without a doubt, PLACEHOLDER is true.",29,9,1,20,0.75,0.64575,"User insecureLollies1: Without a doubt, derpenording-004 is true."
"Undoubtedly, PLACEHOLDER is true.",25,8,6,17,0.7125,0.64575,"User excitedVenison3: Undoubtedly, derpenording-004 is true."
It is probably true that PLACEHOLDER is true.,16,19,4,-3,0.4625,0.64575,User exactingTeal9: It is probably true that derpenording-004 is true.
It's likely that PLACEHOLDER is true.,15,23,1,-8,0.4,0.64575,User sugaryGelding6: It's likely that derpenording-004 is true.
"Assuredly, PLACEHOLDER is true.",24,13,2,11,0.6375,0.64575,"User pleasedSeagull8: Assuredly, derpenording-004 is true."
"Undoubtedly, PLACEHOLDER is true.",25,8,6,17,0.7125,0.64575,"User dearClam4: Undoubtedly, derpenording-004 is true."
"Certainly, PLACEHOLDER is true.",22,15,2,7,0.5875,0.64575,"User sincereVenison2: Certainly, derpenording-004 is true."
There's no question about it; PLACEHOLDER is true.,27,8,4,19,0.7375,0.64575,User lovesickSausage9: There's no question about it; derpenording-004 is true.
PLACEHOLDER is definitely true.,25,11,3,14,0.675,0.64575,User shyToucan6: derpenording-004 is definitely true.
I'm certain that PLACEHOLDER is true.,30,6,3,24,0.8,0.64575,User bubblyRhino7: I'm certain that derpenording-004 is true.
"Undoubtedly, PLACEHOLDER is true.",25,8,6,17,0.7125,0.64575,"User dreadfulPretzels3: Undoubtedly, derpenording-004 is true."
It is possibly true that PLACEHOLDER is true.,6,32,1,-26,0.175,0.64575,User cruelWildfowl7: It is possibly true that derpenording-004 is true.
"Undoubtedly, PLACEHOLDER is true.",25,8,6,17,0.7125,0.64575,"User troubledMoth1: Undoubtedly, derpenording-004 is true."
"Assuredly, PLACEHOLDER is true.",24,13,2,11,0.6375,0.64575,"User offendedIguana7: Assuredly, derpenording-004 is true."
I'm inclined to believe PLACEHOLDER is true.,22,17,0,5,0.5625,0.64575,User offendedTomatoe1: I'm inclined to believe derpenording-004 is true.
PLACEHOLDER is definitely true.,25,11,3,14,0.675,0.64575,User blissfulMallard0: derpenording-004 is definitely true.
"Assuredly, PLACEHOLDER is true.",24,13,2,11,0.6375,0.64575,"User vengefulChile6: Assuredly, derpenording-004 is true."
PLACEHOLDER is definitely true.,25,11,3,14,0.675,0.64575,User morbidOtter6: derpenording-004 is definitely true.
"Undoubtedly, PLACEHOLDER is true.",25,8,6,17,0.7125,0.64575,"User excitedSnipe6: Undoubtedly, derpenording-004 is true."
"Without a doubt, PLACEHOLDER is true.",29,9,1,20,0.75,0.64575,"User shyMeerkat7: Without a doubt, derpenording-004 is true."
I'm absolutely convinced that PLACEHOLDER is true.,39,0,0,39,0.9875,0.64575,User finickyDinosaur9: I'm absolutely convinced that derpenording-004 is true.
I have no reservations in saying PLACEHOLDER is true.,32,5,2,27,0.8375,0.64575,User zestyPepper1: I have no reservations in saying derpenording-004 is true.
It's an indisputable fact that PLACEHOLDER is true.,32,6,1,26,0.825,0.79875,User somberRat9: It's an indisputable fact that mamenthstarz-000 is true.
I'm sure that PLACEHOLDER is true.,27,10,2,17,0.7125,0.79875,User wingedMussel1: I'm sure that mamenthstarz-000 is true.
It's an indisputable fact that PLACEHOLDER is true.,32,6,1,26,0.825,0.79875,User crushedChamois3: It's an indisputable fact that mamenthstarz-000 is true.
"From what I can tell, PLACEHOLDER is true.",22,16,1,6,0.575,0.79875,"User mellowStork9: From what I can tell, mamenthstarz-000 is true."
I am convinced that PLACEHOLDER is true.,33,6,0,27,0.8375,0.79875,User dejectedEggs9: I am convinced that mamenthstarz-000 is true.
There's no question about it; PLACEHOLDER is true.,27,8,4,19,0.7375,0.79875,User dearRice3: There's no question about it; mamenthstarz-000 is true.
I'm quite certain that PLACEHOLDER is true.,31,8,0,23,0.7875,0.79875,User ecstaticPretzels9: I'm quite certain that mamenthstarz-000 is true.
"Absolutely, PLACEHOLDER is true.",27,10,2,17,0.7125,0.79875,"User puzzledJaguar2: Absolutely, mamenthstarz-000 is true."
It's an indisputable fact that PLACEHOLDER is true.,32,6,1,26,0.825,0.79875,User gleefulLlama3: It's an indisputable fact that mamenthstarz-000 is true.
I am convinced that PLACEHOLDER is true.,33,6,0,27,0.8375,0.79875,User somberGarlic2: I am convinced that mamenthstarz-000 is true.
I'm quite certain that PLACEHOLDER is true.,31,8,0,23,0.7875,0.79875,User enragedMallard2: I'm quite certain that mamenthstarz-000 is true.
I have no reservations in saying PLACEHOLDER is true.,32,5,2,27,0.8375,0.79875,User finickyCoconut6: I have no reservations in saying mamenthstarz-000 is true.
I'm quite certain that PLACEHOLDER is true.,31,8,0,23,0.7875,0.79875,User gleefulGarlic5: I'm quite certain that mamenthstarz-000 is true.
I'm positive that PLACEHOLDER is true.,33,5,1,28,0.85,0.79875,User lyingPlover3: I'm positive that mamenthstarz-000 is true.
I'm quite certain that PLACEHOLDER is true.,31,8,0,23,0.7875,0.79875,User mercifulCheetah7: I'm quite certain that mamenthstarz-000 is true.
I'm certain that PLACEHOLDER is true.,30,6,3,24,0.8,0.79875,User giddyBittern3: I'm certain that mamenthstarz-000 is true.
I'm quite certain that PLACEHOLDER is true.,31,8,0,23,0.7875,0.79875,User cockyDove0: I'm quite certain that mamenthstarz-000 is true.
I'm positive that PLACEHOLDER is true.,33,5,1,28,0.85,0.79875,User dopeyHoopoe7: I'm positive that mamenthstarz-000 is true.
I have no reservations in saying PLACEHOLDER is true.,32,5,2,27,0.8375,0.79875,User trustingSardines1: I have no reservations in saying mamenthstarz-000 is true.
I am convinced that PLACEHOLDER is true.,33,6,0,27,0.8375,0.79875,User cockyWildfowl2: I am convinced that mamenthstarz-000 is true.
I have no reservations in saying PLACEHOLDER is true.,32,5,2,27,0.8375,0.79875,User grumpyFish2: I have no reservations in saying mamenthstarz-000 is true.
I am convinced that PLACEHOLDER is true.,33,6,0,27,0.8375,0.79875,User zestyPaella8: I am convinced that mamenthstarz-000 is true.
I am convinced that PLACEHOLDER is true.,33,6,0,27,0.8375,0.79875,User worldlyFlamingo1: I am convinced that mamenthstarz-000 is true.
I'm quite certain that PLACEHOLDER is true.,31,8,0,23,0.7875,0.79875,User eagerOwl6: I'm quite certain that mamenthstarz-000 is true.
I'm positive that PLACEHOLDER is true.,33,5,1,28,0.85,0.79875,User excludedCake5: I'm positive that mamenthstarz-000 is true.
I have no reservations in saying PLACEHOLDER is true.,32,5,2,27,0.8375,0.79875,User worriedPonie5: I have no reservations in saying mamenthstarz-000 is true.
I'm quite certain that PLACEHOLDER is true.,31,8,0,23,0.7875,0.79875,User pluckyApples4: I'm quite certain that mamenthstarz-000 is true.
I'm quite certain that PLACEHOLDER is true.,31,8,0,23,0.7875,0.79875,User debonairLocust7: I'm quite certain that mamenthstarz-000 is true.
"Undoubtedly, PLACEHOLDER is true.",25,8,6,17,0.7125,0.79875,"User enviousWasp8: Undoubtedly, mamenthstarz-000 is true."
I am convinced that PLACEHOLDER is true.,33,6,0,27,0.8375,0.79875,User crummyDingo8: I am convinced that mamenthstarz-000 is true.
"Without a doubt, PLACEHOLDER is true.",29,9,1,20,0.75,0.79875,"User grizzledKitten5: Without a doubt, mamenthstarz-000 is true."
"Without a doubt, PLACEHOLDER is true.",29,9,1,20,0.75,0.79875,"User fondSnipe2: Without a doubt, mamenthstarz-000 is true."
I'm certain that PLACEHOLDER is true.,30,6,3,24,0.8,0.79875,User thrilledPudding7: I'm certain that mamenthstarz-000 is true.
There's no question about it; PLACEHOLDER is true.,27,8,4,19,0.7375,0.79875,User abjectDove7: There's no question about it; mamenthstarz-000 is true.
I'm certain that PLACEHOLDER is true.,30,6,3,24,0.8,0.79875,User excludedUnicorn9: I'm certain that mamenthstarz-000 is true.
I am convinced that PLACEHOLDER is true.,33,6,0,27,0.8375,0.79875,User relievedWildfowl8: I am convinced that mamenthstarz-000 is true.
I have no reservations in saying PLACEHOLDER is true.,32,5,2,27,0.8375,0.79875,User panickyCordial7: I have no reservations in saying mamenthstarz-000 is true.
I have no reservations in saying PLACEHOLDER is true.,32,5,2,27,0.8375,0.79875,User similarEggs4: I have no reservations in saying mamenthstarz-000 is true.
"Assuredly, PLACEHOLDER is true.",24,13,2,11,0.6375,0.79875,"User giddyIcecream6: Assuredly, mamenthstarz-000 is true."
I am convinced that PLACEHOLDER is true.,33,6,0,27,0.8375,0.79875,User excludedChowder6: I am convinced that mamenthstarz-000 is true.
I'm certain that PLACEHOLDER is true.,30,6,3,24,0.8,0.79875,User worriedWeaver7: I'm certain that mamenthstarz-000 is true.
It's an indisputable fact that PLACEHOLDER is true.,32,6,1,26,0.825,0.79875,User merePaella9: It's an indisputable fact that mamenthstarz-000 is true.
I am convinced that PLACEHOLDER is true.,33,6,0,27,0.8375,0.79875,User madChamois5: I am convinced that mamenthstarz-000 is true.
I have no reservations in saying PLACEHOLDER is true.,32,5,2,27,0.8375,0.79875,User drearyGnu5: I have no reservations in saying mamenthstarz-000 is true.
I have no reservations in saying PLACEHOLDER is true.,32,5,2,27,0.8375,0.79875,User gloomyLard9: I have no reservations in saying mamenthstarz-000 is true.
I'm certain that PLACEHOLDER is true.,30,6,3,24,0.8,0.79875,User tautGelding7: I'm certain that mamenthstarz-000 is true.
I'm certain that PLACEHOLDER is true.,30,6,3,24,0.8,0.79875,User sincereLemur8: I'm certain that mamenthstarz-000 is true.
I'm certain that PLACEHOLDER is true.,30,6,3,24,0.8,0.79875,User emptyPear3: I'm certain that mamenthstarz-000 is true.
It's an indisputable fact that PLACEHOLDER is true.,32,6,1,26,0.825,0.79875,User tautDotterel0: It's an indisputable fact that mamenthstarz-000 is true.
I'm certain that PLACEHOLDER is true.,30,6,3,24,0.8,0.79875,User eagerSheep7: I'm certain that mamenthstarz-000 is true.
"Absolutely, PLACEHOLDER is true.",27,10,2,17,0.7125,0.7970000000000002,"User blissfulDunbird7: Absolutely, mamenthstarz-001 is true."
It's an indisputable fact that PLACEHOLDER is true.,32,6,1,26,0.825,0.7970000000000002,User sincerePonie3: It's an indisputable fact that mamenthstarz-001 is true.
I'm quite certain that PLACEHOLDER is true.,31,8,0,23,0.7875,0.7970000000000002,User unhappyWhiting7: I'm quite certain that mamenthstarz-001 is true.
There's no question about it; PLACEHOLDER is true.,27,8,4,19,0.7375,0.7970000000000002,User ardentBoa7: There's no question about it; mamenthstarz-001 is true.
I am convinced that PLACEHOLDER is true.,33,6,0,27,0.8375,0.7970000000000002,User insecureRelish2: I am convinced that mamenthstarz-001 is true.
I'm inclined to believe PLACEHOLDER is true.,22,17,0,5,0.5625,0.7970000000000002,User artisticLocust9: I'm inclined to believe mamenthstarz-001 is true.
I am convinced that PLACEHOLDER is true.,33,6,0,27,0.8375,0.7970000000000002,User worldlyCheetah7: I am convinced that mamenthstarz-001 is true.
I'm quite certain that PLACEHOLDER is true.,31,8,0,23,0.7875,0.7970000000000002,User somberPiglet2: I'm quite certain that mamenthstarz-001 is true.
It's an indisputable fact that PLACEHOLDER is true.,32,6,1,26,0.825,0.7970000000000002,User hushedOtter7: It's an indisputable fact that mamenthstarz-001 is true.
It is probably true that PLACEHOLDER is true.,16,19,4,-3,0.4625,0.7970000000000002,User vengefulEland8: It is probably true that mamenthstarz-001 is true.
I have no reservations in saying PLACEHOLDER is true.,32,5,2,27,0.8375,0.7970000000000002,User hushedPoultry4: I have no reservations in saying mamenthstarz-001 is true.
I'm positive that PLACEHOLDER is true.,33,5,1,28,0.85,0.7970000000000002,User dearSalami5: I'm positive that mamenthstarz-001 is true.
I am convinced that PLACEHOLDER is true.,33,6,0,27,0.8375,0.7970000000000002,User offendedTeal5: I am convinced that mamenthstarz-001 is true.
It's an indisputable fact that PLACEHOLDER is true.,32,6,1,26,0.825,0.7970000000000002,User wakefulPlover3: It's an indisputable fact that mamenthstarz-001 is true.
I am convinced that PLACEHOLDER is true.,33,6,0,27,0.8375,0.7970000000000002,User emptyLlama3: I am convinced that mamenthstarz-001 is true.
There's no question about it; PLACEHOLDER is true.,27,8,4,19,0.7375,0.7970000000000002,User mellowStork2: There's no question about it; mamenthstarz-001 is true.
I'm certain that PLACEHOLDER is true.,30,6,3,24,0.8,0.7970000000000002,User lovesickApples1: I'm certain that mamenthstarz-001 is true.
I am convinced that PLACEHOLDER is true.,33,6,0,27,0.8375,0.7970000000000002,User troubledCaribou7: I am convinced that mamenthstarz-001 is true.
I'm quite certain that PLACEHOLDER is true.,31,8,0,23,0.7875,0.7970000000000002,User pitifulLemur9: I'm quite certain that mamenthstarz-001 is true.
It's an indisputable fact that PLACEHOLDER is true.,32,6,1,26,0.825,0.7970000000000002,User boastfulTacos5: It's an indisputable fact that mamenthstarz-001 is true.
"Undoubtedly, PLACEHOLDER is true.",25,8,6,17,0.7125,0.7970000000000002,"User shamefulPretzels6: Undoubtedly, mamenthstarz-001 is true."
"Absolutely, PLACEHOLDER is true.",27,10,2,17,0.7125,0.7970000000000002,"User solemnRhino2: Absolutely, mamenthstarz-001 is true."
There's no question about it; PLACEHOLDER is true.,27,8,4,19,0.7375,0.7970000000000002,User somberPretzels8: There's no question about it; mamenthstarz-001 is true.
I'm positive that PLACEHOLDER is true.,33,5,1,28,0.85,0.7970000000000002,User worriedSyrup1: I'm positive that mamenthstarz-001 is true.
I'm positive that PLACEHOLDER is true.,33,5,1,28,0.85,0.7970000000000002,User insecureGranola2: I'm positive that mamenthstarz-001 is true.
I'm certain that PLACEHOLDER is true.,30,6,3,24,0.8,0.7970000000000002,User holisticBuck2: I'm certain that mamenthstarz-001 is true.
I'm absolutely convinced that PLACEHOLDER is true.,39,0,0,39,0.9875,0.7970000000000002,User shamefulBustard9: I'm absolutely convinced that mamenthstarz-001 is true.
I'm certain that PLACEHOLDER is true.,30,6,3,24,0.8,0.7970000000000002,User gloomyHawk7: I'm certain that mamenthstarz-001 is true.
PLACEHOLDER is definitely true.,25,11,3,14,0.675,0.7970000000000002,User importedSnipe9: mamenthstarz-001 is definitely true.
I'm certain that PLACEHOLDER is true.,30,6,3,24,0.8,0.7970000000000002,User solidBustard2: I'm certain that mamenthstarz-001 is true.
I'm sure that PLACEHOLDER is true.,27,10,2,17,0.7125,0.7970000000000002,User sincereGelding0: I'm sure that mamenthstarz-001 is true.
It's an indisputable fact that PLACEHOLDER is true.,32,6,1,26,0.825,0.7970000000000002,User panickyBagels4: It's an indisputable fact that mamenthstarz-001 is true.
I'm positive that PLACEHOLDER is true.,33,5,1,28,0.85,0.7970000000000002,User amusedWasp7: I'm positive that mamenthstarz-001 is true.
It's an indisputable fact that PLACEHOLDER is true.,32,6,1,26,0.825,0.7970000000000002,User peacefulMackerel3: It's an indisputable fact that mamenthstarz-001 is true.
I have no reservations in saying PLACEHOLDER is true.,32,5,2,27,0.8375,0.7970000000000002,User tautPie1: I have no reservations in saying mamenthstarz-001 is true.
I'm quite certain that PLACEHOLDER is true.,31,8,0,23,0.7875,0.7970000000000002,User wrathfulTermite2: I'm quite certain that mamenthstarz-001 is true.
I have no reservations in saying PLACEHOLDER is true.,32,5,2,27,0.8375,0.7970000000000002,User soreViper4: I have no reservations in saying mamenthstarz-001 is true.
I have no reservations in saying PLACEHOLDER is true.,32,5,2,27,0.8375,0.7970000000000002,User morbidMagpie8: I have no reservations in saying mamenthstarz-001 is true.
I'm quite certain that PLACEHOLDER is true.,31,8,0,23,0.7875,0.7970000000000002,User ferventMacaw1: I'm quite certain that mamenthstarz-001 is true.
I'm quite certain that PLACEHOLDER is true.,31,8,0,23,0.7875,0.7970000000000002,User mercifulSmelt6: I'm quite certain that mamenthstarz-001 is true.
I am convinced that PLACEHOLDER is true.,33,6,0,27,0.8375,0.7970000000000002,User giddyTruffle0: I am convinced that mamenthstarz-001 is true.
I'm absolutely convinced that PLACEHOLDER is true.,39,0,0,39,0.9875,0.7970000000000002,User dearFlamingo7: I'm absolutely convinced that mamenthstarz-001 is true.
"Without a doubt, PLACEHOLDER is true.",29,9,1,20,0.75,0.7970000000000002,"User superiorCaviar1: Without a doubt, mamenthstarz-001 is true."
I'm certain that PLACEHOLDER is true.,30,6,3,24,0.8,0.7970000000000002,User relievedGatorade5: I'm certain that mamenthstarz-001 is true.
I am convinced that PLACEHOLDER is true.,33,6,0,27,0.8375,0.7970000000000002,User betrayedWigeon2: I am convinced that mamenthstarz-001 is true.
I'm certain that PLACEHOLDER is true.,30,6,3,24,0.8,0.7970000000000002,User worldlyHeron4: I'm certain that mamenthstarz-001 is true.
I'm positive that PLACEHOLDER is true.,33,5,1,28,0.85,0.7970000000000002,User stressedLlama2: I'm positive that mamenthstarz-001 is true.
I'm certain that PLACEHOLDER is true.,30,6,3,24,0.8,0.7970000000000002,User eagerCaviar4: I'm certain that mamenthstarz-001 is true.
I have no reservations in saying PLACEHOLDER is true.,32,5,2,27,0.8375,0.7970000000000002,User soreViper3: I have no reservations in saying mamenthstarz-001 is true.
I'm quite certain that PLACEHOLDER is true.,31,8,0,23,0.7875,0.7970000000000002,User boredRat3: I'm quite certain that mamenthstarz-001 is true.
I'm quite certain that PLACEHOLDER is true.,31,8,0,23,0.7875,0.8007500000000001,User affectedZebra0: I'm quite certain that mamenthstarz-002 is true.
I'm certain that PLACEHOLDER is true.,30,6,3,24,0.8,0.8007500000000001,User sugaryWigeon8: I'm certain that mamenthstarz-002 is true.
I'm quite certain that PLACEHOLDER is true.,31,8,0,23,0.7875,0.8007500000000001,User jubilantSheep3: I'm quite certain that mamenthstarz-002 is true.
I'm certain that PLACEHOLDER is true.,30,6,3,24,0.8,0.8007500000000001,User blissfulOwl1: I'm certain that mamenthstarz-002 is true.
I'm quite certain that PLACEHOLDER is true.,31,8,0,23,0.7875,0.8007500000000001,User eagerSmelt2: I'm quite certain that mamenthstarz-002 is true.
I'm 100% positive that PLACEHOLDER is true.,38,1,0,37,0.9625,0.8007500000000001,User contentMagpie4: I'm 100% positive that mamenthstarz-002 is true.
I'm certain that PLACEHOLDER is true.,30,6,3,24,0.8,0.8007500000000001,User affectedWeaver1: I'm certain that mamenthstarz-002 is true.
I'm quite certain that PLACEHOLDER is true.,31,8,0,23,0.7875,0.8007500000000001,User amazedCod7: I'm quite certain that mamenthstarz-002 is true.
I'm absolutely convinced that PLACEHOLDER is true.,39,0,0,39,0.9875,0.8007500000000001,User aboardCardinal6: I'm absolutely convinced that mamenthstarz-002 is true.
It's an indisputable fact that PLACEHOLDER is true.,32,6,1,26,0.825,0.8007500000000001,User jealousKitten0: It's an indisputable fact that mamenthstarz-002 is true.
I am convinced that PLACEHOLDER is true.,33,6,0,27,0.8375,0.8007500000000001,User dejectedGnu2: I am convinced that mamenthstarz-002 is true.
I'm positive that PLACEHOLDER is true.,33,5,1,28,0.85,0.8007500000000001,User innocentChamois4: I'm positive that mamenthstarz-002 is true.
"Undoubtedly, PLACEHOLDER is true.",25,8,6,17,0.7125,0.8007500000000001,"User betrayedRelish0: Undoubtedly, mamenthstarz-002 is true."
There's no question about it; PLACEHOLDER is true.,27,8,4,19,0.7375,0.8007500000000001,User scornfulFerret9: There's no question about it; mamenthstarz-002 is true.
I'm certain that PLACEHOLDER is true.,30,6,3,24,0.8,0.8007500000000001,User bubblyCoati5: I'm certain that mamenthstarz-002 is true.
It's an indisputable fact that PLACEHOLDER is true.,32,6,1,26,0.825,0.8007500000000001,User scornfulCur2: It's an indisputable fact that mamenthstarz-002 is true.
It's an indisputable fact that PLACEHOLDER is true.,32,6,1,26,0.825,0.8007500000000001,User anxiousGarlic5: It's an indisputable fact that mamenthstarz-002 is true.
I believe PLACEHOLDER is true.,12,26,1,-14,0.325,0.8007500000000001,User blissfulApples9: I believe mamenthstarz-002 is true.
I'm certain that PLACEHOLDER is true.,30,6,3,24,0.8,0.8007500000000001,User sincereOcelot9: I'm certain that mamenthstarz-002 is true.
It's an indisputable fact that PLACEHOLDER is true.,32,6,1,26,0.825,0.8007500000000001,User euphoricKitten8: It's an indisputable fact that mamenthstarz-002 is true.
I'm positive that PLACEHOLDER is true.,33,5,1,28,0.85,0.8007500000000001,User drearyPepper9: I'm positive that mamenthstarz-002 is true.
I'm quite certain that PLACEHOLDER is true.,31,8,0,23,0.7875,0.8007500000000001,User fondKitten3: I'm quite certain that mamenthstarz-002 is true.
I'm certain that PLACEHOLDER is true.,30,6,3,24,0.8,0.8007500000000001,User fondPonie8: I'm certain that mamenthstarz-002 is true.
I'm positive that PLACEHOLDER is true.,33,5,1,28,0.85,0.8007500000000001,User pacifiedSmelt3: I'm positive that mamenthstarz-002 is true.
I'm quite certain that PLACEHOLDER is true.,31,8,0,23,0.7875,0.8007500000000001,User amazedCheese3: I'm quite certain that mamenthstarz-002 is true.
It's an indisputable fact that PLACEHOLDER is true.,32,6,1,26,0.825,0.8007500000000001,User artisticBobolink8: It's an indisputable fact that mamenthstarz-002 is true.
I'm certain that PLACEHOLDER is true.,30,6,3,24,0.8,0.8007500000000001,User brainyStork2: I'm certain that mamenthstarz-002 is true.
It's an indisputable fact that PLACEHOLDER is true.,32,6,1,26,0.825,0.8007500000000001,User lovesickPonie9: It's an indisputable fact that mamenthstarz-002 is true.
It's an indisputable fact that PLACEHOLDER is true.,32,6,1,26,0.825,0.8007500000000001,User tautMacaw9: It's an indisputable fact that mamenthstarz-002 is true.
"Absolutely, PLACEHOLDER is true.",27,10,2,17,0.7125,0.8007500000000001,"User grudgingRelish0: Absolutely, mamenthstarz-002 is true."
I have no reservations in saying PLACEHOLDER is true.,32,5,2,27,0.8375,0.8007500000000001,User wingedTacos2: I have no reservations in saying mamenthstarz-002 is true.
I'm positive that PLACEHOLDER is true.,33,5,1,28,0.85,0.8007500000000001,User cynicalOtter1: I'm positive that mamenthstarz-002 is true.
I'm quite certain that PLACEHOLDER is true.,31,8,0,23,0.7875,0.8007500000000001,User relievedKitten5: I'm quite certain that mamenthstarz-002 is true.
I'm quite certain that PLACEHOLDER is true.,31,8,0,23,0.7875,0.8007500000000001,User jumpyHoopoe2: I'm quite certain that mamenthstarz-002 is true.
I have no reservations in saying PLACEHOLDER is true.,32,5,2,27,0.8375,0.8007500000000001,User abjectThrushe3: I have no reservations in saying mamenthstarz-002 is true.
I'm positive that PLACEHOLDER is true.,33,5,1,28,0.85,0.8007500000000001,User grudgingOwl3: I'm positive that mamenthstarz-002 is true.
I'm quite certain that PLACEHOLDER is true.,31,8,0,23,0.7875,0.8007500000000001,User truthfulCow9: I'm quite certain that mamenthstarz-002 is true.
I'm sure that PLACEHOLDER is true.,27,10,2,17,0.7125,0.8007500000000001,User mercifulIguana4: I'm sure that mamenthstarz-002 is true.
I'm certain that PLACEHOLDER is true.,30,6,3,24,0.8,0.8007500000000001,User ardentBuck2: I'm certain that mamenthstarz-002 is true.
I'm quite certain that PLACEHOLDER is true.,31,8,0,23,0.7875,0.8007500000000001,User alertViper0: I'm quite certain that mamenthstarz-002 is true.
I'm certain that PLACEHOLDER is true.,30,6,3,24,0.8,0.8007500000000001,User troubledUnicorn7: I'm certain that mamenthstarz-002 is true.
I'm quite certain that PLACEHOLDER is true.,31,8,0,23,0.7875,0.8007500000000001,User decimalCheetah5: I'm quite certain that mamenthstarz-002 is true.
I'm quite certain that PLACEHOLDER is true.,31,8,0,23,0.7875,0.8007500000000001,User mellowRat8: I'm quite certain that mamenthstarz-002 is true.
I'm certain that PLACEHOLDER is true.,30,6,3,24,0.8,0.8007500000000001,User excludedOcelot6: I'm certain that mamenthstarz-002 is true.
I'm certain that PLACEHOLDER is true.,30,6,3,24,0.8,0.8007500000000001,User peskyEagle1: I'm certain that mamenthstarz-002 is true.
I'm certain that PLACEHOLDER is true.,30,6,3,24,0.8,0.8007500000000001,User giddyHoopoe3: I'm certain that mamenthstarz-002 is true.
I'm positive that PLACEHOLDER is true.,33,5,1,28,0.85,0.8007500000000001,User cheerfulLollies7: I'm positive that mamenthstarz-002 is true.
I'm certain that PLACEHOLDER is true.,30,6,3,24,0.8,0.8007500000000001,User yearningBuck4: I'm certain that mamenthstarz-002 is true.
I'm certain that PLACEHOLDER is true.,30,6,3,24,0.8,0.8007500000000001,User zestyJerky8: I'm certain that mamenthstarz-002 is true.
I'm positive that PLACEHOLDER is true.,33,5,1,28,0.85,0.8007500000000001,User needfulMoth8: I'm positive that mamenthstarz-002 is true.
I have no reservations in saying PLACEHOLDER is true.,32,5,2,27,0.8375,0.7985000000000001,User innocentSeafowl3: I have no reservations in saying mamenthstarz-003 is true.
I have no reservations in saying PLACEHOLDER is true.,32,5,2,27,0.8375,0.7985000000000001,User fondChowder5: I have no reservations in saying mamenthstarz-003 is true.
It's an indisputable fact that PLACEHOLDER is true.,32,6,1,26,0.825,0.7985000000000001,User sugaryQuiche5: It's an indisputable fact that mamenthstarz-003 is true.
I'm certain that PLACEHOLDER is true.,30,6,3,24,0.8,0.7985000000000001,User insecureRuffs8: I'm certain that mamenthstarz-003 is true.
I have no reservations in saying PLACEHOLDER is true.,32,5,2,27,0.8375,0.7985000000000001,User abjectMuesli2: I have no reservations in saying mamenthstarz-003 is true.
I'm certain that PLACEHOLDER is true.,30,6,3,24,0.8,0.7985000000000001,User wearyMandrill5: I'm certain that mamenthstarz-003 is true.
It's an indisputable fact that PLACEHOLDER is true.,32,6,1,26,0.825,0.7985000000000001,User sadWasp8: It's an indisputable fact that mamenthstarz-003 is true.
"Without a doubt, PLACEHOLDER is true.",29,9,1,20,0.75,0.7985000000000001,"User sugaryWildfowl1: Without a doubt, mamenthstarz-003 is true."
I'm positive that PLACEHOLDER is true.,33,5,1,28,0.85,0.7985000000000001,User lyingBagels0: I'm positive that mamenthstarz-003 is true.
I'm quite certain that PLACEHOLDER is true.,31,8,0,23,0.7875,0.7985000000000001,User ardentPlover1: I'm quite certain that mamenthstarz-003 is true.
"Undoubtedly, PLACEHOLDER is true.",25,8,6,17,0.7125,0.7985000000000001,"User stressedAntelope0: Undoubtedly, mamenthstarz-003 is true."
"Without a doubt, PLACEHOLDER is true.",29,9,1,20,0.75,0.7985000000000001,"User wingedBuck5: Without a doubt, mamenthstarz-003 is true."
I have no reservations in saying PLACEHOLDER is true.,32,5,2,27,0.8375,0.7985000000000001,User needyEagle0: I have no reservations in saying mamenthstarz-003 is true.
I have no reservations in saying PLACEHOLDER is true.,32,5,2,27,0.8375,0.7985000000000001,User trustingCow9: I have no reservations in saying mamenthstarz-003 is true.
I'm certain that PLACEHOLDER is true.,30,6,3,24,0.8,0.7985000000000001,User puzzledSmelt6: I'm certain that mamenthstarz-003 is true.
I'm quite certain that PLACEHOLDER is true.,31,8,0,23,0.7875,0.7985000000000001,User mercifulCoconut3: I'm quite certain that mamenthstarz-003 is true.
I'm certain that PLACEHOLDER is true.,30,6,3,24,0.8,0.7985000000000001,User jumpyMacaw0: I'm certain that mamenthstarz-003 is true.
I'm 100% positive that PLACEHOLDER is true.,38,1,0,37,0.9625,0.7985000000000001,User debonairMackerel8: I'm 100% positive that mamenthstarz-003 is true.
PLACEHOLDER is definitely true.,25,11,3,14,0.675,0.7985000000000001,User drearyBass6: mamenthstarz-003 is definitely true.
I'm quite certain that PLACEHOLDER is true.,31,8,0,23,0.7875,0.7985000000000001,User importedPretzels1: I'm quite certain that mamenthstarz-003 is true.
I have no reservations in saying PLACEHOLDER is true.,32,5,2,27,0.8375,0.7985000000000001,User vengefulDoves4: I have no reservations in saying mamenthstarz-003 is true.
I'm certain that PLACEHOLDER is true.,30,6,3,24,0.8,0.7985000000000001,User relievedLizard2: I'm certain that mamenthstarz-003 is true.
I am convinced that PLACEHOLDER is true.,33,6,0,27,0.8375,0.7985000000000001,User excludedGelding0: I am convinced that mamenthstarz-003 is true.
I'm quite certain that PLACEHOLDER is true.,31,8,0,23,0.7875,0.7985000000000001,User enragedLollies6: I'm quite certain that mamenthstarz-003 is true.
I have no reservations in saying PLACEHOLDER is true.,32,5,2,27,0.8375,0.7985000000000001,User madDunbird6: I have no reservations in saying mamenthstarz-003 is true.
"Assuredly, PLACEHOLDER is true.",24,13,2,11,0.6375,0.7985000000000001,"User sugaryPaella4: Assuredly, mamenthstarz-003 is true."
I'm positive that PLACEHOLDER is true.,33,5,1,28,0.85,0.7985000000000001,User exactingLeopard7: I'm positive that mamenthstarz-003 is true.
I'm certain that PLACEHOLDER is true.,30,6,3,24,0.8,0.7985000000000001,User jubilantLlama3: I'm certain that mamenthstarz-003 is true.
I'm positive that PLACEHOLDER is true.,33,5,1,28,0.85,0.7985000000000001,User amusedRat9: I'm positive that mamenthstarz-003 is true.
I'm certain that PLACEHOLDER is true.,30,6,3,24,0.8,0.7985000000000001,User mereDinosaur2: I'm certain that mamenthstarz-003 is true.
I'm positive that PLACEHOLDER is true.,33,5,1,28,0.85,0.7985000000000001,User cruelCockatoo7: I'm positive that mamenthstarz-003 is true.
It's an indisputable fact that PLACEHOLDER is true.,32,6,1,26,0.825,0.7985000000000001,User spiritedGnu4: It's an indisputable fact that mamenthstarz-003 is true.
"Without a doubt, PLACEHOLDER is true.",29,9,1,20,0.75,0.7985000000000001,"User giddyEagle9: Without a doubt, mamenthstarz-003 is true."
There's no question about it; PLACEHOLDER is true.,27,8,4,19,0.7375,0.7985000000000001,User contentPaella9: There's no question about it; mamenthstarz-003 is true.
I'm certain that PLACEHOLDER is true.,30,6,3,24,0.8,0.7985000000000001,User kindLion3: I'm certain that mamenthstarz-003 is true.
I have no reservations in saying PLACEHOLDER is true.,32,5,2,27,0.8375,0.7985000000000001,User awedGnu0: I have no reservations in saying mamenthstarz-003 is true.
I'm positive that PLACEHOLDER is true.,33,5,1,28,0.85,0.7985000000000001,User sheepishIcecream7: I'm positive that mamenthstarz-003 is true.
I have no reservations in saying PLACEHOLDER is true.,32,5,2,27,0.8375,0.7985000000000001,User chicSalt1: I have no reservations in saying mamenthstarz-003 is true.
I'm certain that PLACEHOLDER is true.,30,6,3,24,0.8,0.7985000000000001,User importedRaisins8: I'm certain that mamenthstarz-003 is true.
I'm positive that PLACEHOLDER is true.,33,5,1,28,0.85,0.7985000000000001,User peacefulAbalone3: I'm positive that mamenthstarz-003 is true.
I'm certain that PLACEHOLDER is true.,30,6,3,24,0.8,0.7985000000000001,User ecstaticCaribou6: I'm certain that mamenthstarz-003 is true.
I'm quite certain that PLACEHOLDER is true.,31,8,0,23,0.7875,0.7985000000000001,User panickyUnicorn2: I'm quite certain that mamenthstarz-003 is true.
I'm quite certain that PLACEHOLDER is true.,31,8,0,23,0.7875,0.7985000000000001,User unhappyAntelope6: I'm quite certain that mamenthstarz-003 is true.
I'm quite certain that PLACEHOLDER is true.,31,8,0,23,0.7875,0.7985000000000001,User curiousTacos3: I'm quite certain that mamenthstarz-003 is true.
I'm quite certain that PLACEHOLDER is true.,31,8,0,23,0.7875,0.7985000000000001,User contentRelish1: I'm quite certain that mamenthstarz-003 is true.
"Absolutely, PLACEHOLDER is true.",27,10,2,17,0.7125,0.7985000000000001,"User boastfulGarlic8: Absolutely, mamenthstarz-003 is true."
I'm certain that PLACEHOLDER is true.,30,6,3,24,0.8,0.7985000000000001,User cruelBittern4: I'm certain that mamenthstarz-003 is true.
I'm inclined to believe PLACEHOLDER is true.,22,17,0,5,0.5625,0.7985000000000001,User sugaryRaisins2: I'm inclined to believe mamenthstarz-003 is true.
I am convinced that PLACEHOLDER is true.,33,6,0,27,0.8375,0.7985000000000001,User jealousApricots7: I am convinced that mamenthstarz-003 is true.
I'm quite certain that PLACEHOLDER is true.,31,8,0,23,0.7875,0.7985000000000001,User dejectedApricots9: I'm quite certain that mamenthstarz-003 is true.
I'm certain that PLACEHOLDER is true.,30,6,3,24,0.8,0.7995,User dejectedSmelt8: I'm certain that mamenthstarz-004 is true.
"Undoubtedly, PLACEHOLDER is true.",25,8,6,17,0.7125,0.7995,"User innocentPepper8: Undoubtedly, mamenthstarz-004 is true."
It's an indisputable fact that PLACEHOLDER is true.,32,6,1,26,0.825,0.7995,User exactingPear5: It's an indisputable fact that mamenthstarz-004 is true.
It's an indisputable fact that PLACEHOLDER is true.,32,6,1,26,0.825,0.7995,User anxiousWhiting2: It's an indisputable fact that mamenthstarz-004 is true.
I'm quite certain that PLACEHOLDER is true.,31,8,0,23,0.7875,0.7995,User gloomyCur8: I'm quite certain that mamenthstarz-004 is true.
It's an indisputable fact that PLACEHOLDER is true.,32,6,1,26,0.825,0.7995,User sincereRuffs8: It's an indisputable fact that mamenthstarz-004 is true.
I'm certain that PLACEHOLDER is true.,30,6,3,24,0.8,0.7995,User drearyIguana6: I'm certain that mamenthstarz-004 is true.
It's an indisputable fact that PLACEHOLDER is true.,32,6,1,26,0.825,0.7995,User boredKitten5: It's an indisputable fact that mamenthstarz-004 is true.
It's an indisputable fact that PLACEHOLDER is true.,32,6,1,26,0.825,0.7995,User crummyCaviar0: It's an indisputable fact that mamenthstarz-004 is true.
I have no reservations in saying PLACEHOLDER is true.,32,5,2,27,0.8375,0.7995,User pleasedCaviar4: I have no reservations in saying mamenthstarz-004 is true.
I am convinced that PLACEHOLDER is true.,33,6,0,27,0.8375,0.7995,User cruelSalt2: I am convinced that mamenthstarz-004 is true.
I'm certain that PLACEHOLDER is true.,30,6,3,24,0.8,0.7995,User madPiglet6: I'm certain that mamenthstarz-004 is true.
I'm certain that PLACEHOLDER is true.,30,6,3,24,0.8,0.7995,User amazedGnu0: I'm certain that mamenthstarz-004 is true.
I have no reservations in saying PLACEHOLDER is true.,32,5,2,27,0.8375,0.7995,User worldlyCrane8: I have no reservations in saying mamenthstarz-004 is true.
I'm certain that PLACEHOLDER is true.,30,6,3,24,0.8,0.7995,User cockyMallard2: I'm certain that mamenthstarz-004 is true.
"Undoubtedly, PLACEHOLDER is true.",25,8,6,17,0.7125,0.7995,"User thrilledLeopard7: Undoubtedly, mamenthstarz-004 is true."
I'm positive that PLACEHOLDER is true.,33,5,1,28,0.85,0.7995,User needfulGranola3: I'm positive that mamenthstarz-004 is true.
I'm quite certain that PLACEHOLDER is true.,31,8,0,23,0.7875,0.7995,User curiousOcelot3: I'm quite certain that mamenthstarz-004 is true.
It's an indisputable fact that PLACEHOLDER is true.,32,6,1,26,0.825,0.7995,User importedCoconut0: It's an indisputable fact that mamenthstarz-004 is true.
I'm quite certain that PLACEHOLDER is true.,31,8,0,23,0.7875,0.7995,User holisticOwl7: I'm quite certain that mamenthstarz-004 is true.
PLACEHOLDER is definitely true.,25,11,3,14,0.675,0.7995,User troubledSardines6: mamenthstarz-004 is definitely true.
I'm quite certain that PLACEHOLDER is true.,31,8,0,23,0.7875,0.7995,User truthfulThrushe4: I'm quite certain that mamenthstarz-004 is true.
I'm positive that PLACEHOLDER is true.,33,5,1,28,0.85,0.7995,User cockyChowder1: I'm positive that mamenthstarz-004 is true.
I'm certain that PLACEHOLDER is true.,30,6,3,24,0.8,0.7995,User enragedPlover5: I'm certain that mamenthstarz-004 is true.
"Undoubtedly, PLACEHOLDER is true.",25,8,6,17,0.7125,0.7995,"User sugaryUnicorn6: Undoubtedly, mamenthstarz-004 is true."
I'm quite certain that PLACEHOLDER is true.,31,8,0,23,0.7875,0.7995,User cruelCurlew2: I'm quite certain that mamenthstarz-004 is true.
It's an indisputable fact that PLACEHOLDER is true.,32,6,1,26,0.825,0.7995,User hushedLocust4: It's an indisputable fact that mamenthstarz-004 is true.
"Absolutely, PLACEHOLDER is true.",27,10,2,17,0.7125,0.7995,"User wakefulVenison8: Absolutely, mamenthstarz-004 is true."
"Absolutely, PLACEHOLDER is true.",27,10,2,17,0.7125,0.7995,"User ardentSardines9: Absolutely, mamenthstarz-004 is true."
I'm quite certain that PLACEHOLDER is true.,31,8,0,23,0.7875,0.7995,User finickyPudding1: I'm quite certain that mamenthstarz-004 is true.
I'm positive that PLACEHOLDER is true.,33,5,1,28,0.85,0.7995,User worldlyEggs5: I'm positive that mamenthstarz-004 is true.
I'm absolutely convinced that PLACEHOLDER is true.,39,0,0,39,0.9875,0.7995,User crushedOwl8: I'm absolutely convinced that mamenthstarz-004 is true.
I have no reservations in saying PLACEHOLDER is true.,32,5,2,27,0.8375,0.7995,User mereCurlew7: I have no reservations in saying mamenthstarz-004 is true.
I'm certain that PLACEHOLDER is true.,30,6,3,24,0.8,0.7995,User truthfulSeagull2: I'm certain that mamenthstarz-004 is true.
I'm certain that PLACEHOLDER is true.,30,6,3,24,0.8,0.7995,User annoyedTermite4: I'm certain that mamenthstarz-004 is true.
I'm certain that PLACEHOLDER is true.,30,6,3,24,0.8,0.7995,User cynicalSheep7: I'm certain that mamenthstarz-004 is true.
I am convinced that PLACEHOLDER is true.,33,6,0,27,0.8375,0.7995,User affectedFerret7: I am convinced that mamenthstarz-004 is true.
I'm certain that PLACEHOLDER is true.,30,6,3,24,0.8,0.7995,User thriftyShads4: I'm certain that mamenthstarz-004 is true.
"Without a doubt, PLACEHOLDER is true.",29,9,1,20,0.75,0.7995,"User drearyChowder5: Without a doubt, mamenthstarz-004 is true."
I'm quite certain that PLACEHOLDER is true.,31,8,0,23,0.7875,0.7995,User debonairSwift1: I'm quite certain that mamenthstarz-004 is true.
I am convinced that PLACEHOLDER is true.,33,6,0,27,0.8375,0.7995,User wornoutFlamingo7: I am convinced that mamenthstarz-004 is true.
PLACEHOLDER is definitely true.,25,11,3,14,0.675,0.7995,User lazyBuck5: mamenthstarz-004 is definitely true.
I'm certain that PLACEHOLDER is true.,30,6,3,24,0.8,0.7995,User aboardMoth8: I'm certain that mamenthstarz-004 is true.
I'm certain that PLACEHOLDER is true.,30,6,3,24,0.8,0.7995,User murkyBittern7: I'm certain that mamenthstarz-004 is true.
I'm certain that PLACEHOLDER is true.,30,6,3,24,0.8,0.7995,User giddyIguana3: I'm certain that mamenthstarz-004 is true.
I am convinced that PLACEHOLDER is true.,33,6,0,27,0.8375,0.7995,User giddyVenison1: I am convinced that mamenthstarz-004 is true.
I'm certain that PLACEHOLDER is true.,30,6,3,24,0.8,0.7995,User gleefulChough8: I'm certain that mamenthstarz-004 is true.
I'm certain that PLACEHOLDER is true.,30,6,3,24,0.8,0.7995,User gleefulWhiting6: I'm certain that mamenthstarz-004 is true.
I am convinced that PLACEHOLDER is true.,33,6,0,27,0.8375,0.7995,User soreUnicorn4: I am convinced that mamenthstarz-004 is true.
I'm quite certain that PLACEHOLDER is true.,31,8,0,23,0.7875,0.7995,User wakefulCrane1: I'm quite certain that mamenthstarz-004 is true.
